rtID,rtAllCriticsRating,rtAllCriticsNumReviews,rtAllCriticsNumFresh,rtAllCriticsNumRotten,rtAllCriticsScore,rtTopCriticsRating,rtTopCriticsNumReviews,rtTopCriticsNumFresh,rtTopCriticsNumRotten,rtTopCriticsScore,rtAudienceRating,rtAudienceNumRatings,rtAudienceScore
toy_story,9,73,73,0,100,8.5,17,17,0,100,3.7,102338,81
1068044-jumanji,5.6,28,13,15,46,5.8,5,2,3,40,3.2,44587,61
grumpy_old_men,5.9,36,24,12,66,7,6,5,1,83,3.2,10489,66
waiting_to_exhale,5.6,25,14,11,56,5.5,11,5,6,45,3.3,5666,79
father_of_the_bride_part_ii,5.3,19,9,10,47,5.4,5,1,4,20,3,13761,64
1068182-heat,7.7,58,50,8,86,7.2,17,14,3,82,3.9,42785,92
1018047-sabrina,7.4,31,28,3,90,7.2,5,5,0,100,3.8,12812,87
tom_and_huck,4.2,8,2,6,25,0,2,1,1,50,2.7,2649,45
1068470-sudden_death,5.2,32,17,15,53,5.6,9,5,4,55,2.6,3626,40
goldeneye,6.8,41,33,8,80,6.2,11,7,4,63,3.4,28260,78
american_president,7,49,44,5,89,7.2,18,16,2,88,3.2,8320,71
dracula_dead_and_loving_it,3,35,3,32,8,3.7,10,2,8,20,2.8,10078,52
balto,5.8,12,6,6,50,0,4,1,3,25,3.2,9195,66
nixon,6.7,56,42,14,75,6.1,18,12,6,66,3.5,3256,72
cutthroat_island,4.4,31,14,17,45,4.7,6,3,3,50,2.6,3350,42
1067987-casino,7.2,58,47,11,81,6.3,16,11,5,68,3.9,66463,91
1068832-sense_and_sensibility,7.9,49,48,1,97,8.1,14,13,1,92,3.8,32782,88
four_rooms,3.5,42,6,36,14,2.9,11,0,11,0,3.5,14266,72
ace_ventura_when_nature_calls,4.1,25,9,16,36,0,3,1,2,33,3.2,87306,73
money_train,4,24,4,20,16,4.5,5,1,4,20,2.7,5263,38
get_shorty,7.7,49,42,7,85,8.4,14,14,0,100,3.2,10155,63
1065837-copycat,6.6,32,24,8,75,7.4,5,4,1,80,3.1,5628,58
1198524-ninja_assassin,4.3,106,27,79,25,4.6,20,6,14,30,3.4,107023,58
powder,5.2,19,9,10,47,4.9,5,0,5,0,3.1,6650,67
leaving_las_vegas,7.7,45,40,5,88,8.1,11,11,0,100,3.6,12742,82
1069707-othello,6.3,38,26,12,68,6.1,11,7,4,63,3.3,2018,66
now_and_then,4.7,16,3,13,18,5.2,5,1,4,20,3.5,17168,78
1066528-persuasion,7.7,23,19,4,82,8.5,9,9,0,100,3.9,7968,82
city_of_lost_children,7,33,27,6,81,7.2,7,5,2,71,4,22420,89
shanghai_triad,6.8,21,18,3,85,0,4,3,1,75,3.6,1061,70
dangerous_minds,4.7,37,11,26,29,5,12,5,7,41,3.1,12136,66
prem-no-public-issue,0,0,0,0,0,0,0,0,0,0,0,0,0
1065598-babe,8.2,54,53,1,98,8.2,11,11,0,100,3,22954,54
carrington,6.2,19,9,10,47,7.4,5,4,1,80,3.5,781,68
1068779-dead_man_walking,8.2,53,50,3,94,7.9,20,18,2,90,3.6,15450,81
across_the_sea_of_time,0,4,2,2,50,0,1,0,1,0,2.9,237,27
1067137-it_takes_two,3.9,24,2,22,8,4.6,8,2,6,25,2.9,16311,63
school_of_senses,0,0,0,0,0,0,0,0,0,0,0,0,0
1068781-cry_the_beloved_country,7.2,13,10,3,76,0,4,3,1,75,3.5,520,66
1068177-richard_iii,8.1,43,41,2,95,7.6,11,10,1,90,3.7,1552,82
dead_presidents,5.7,31,14,17,45,6.3,12,7,5,58,3.3,4475,75
1069339-restoration,6.3,31,21,10,67,6.4,10,6,4,60,3.3,1103,56
mortal_kombat,4.4,26,9,17,34,3.9,6,2,4,33,2.8,18291,55
live_free_or_die_hard,6.8,197,161,36,81,6.7,38,30,8,78,3.9,1145097,86
how_to_make_an_american_quilt,5.6,22,11,11,50,7.6,6,5,1,83,3.2,2626,58
1018639-seven_samurai,9.2,49,49,0,100,8.6,10,10,0,100,4.5,29509,97
1063452-pocahontas,6,49,27,22,55,6.6,14,10,4,71,3.2,37858,63
when_night_is_falling,5.7,16,8,8,50,0,4,1,3,25,3.9,1132,83
usual_suspects,7.5,47,41,6,87,6.9,14,12,2,85,4.2,109588,95
mighty_aphrodite,6.7,33,25,8,75,7.2,6,4,2,66,3.3,4866,69
lamerica,8,10,9,1,90,0,1,1,0,100,3.9,239,82
big_green,2.8,5,0,5,0,0,1,0,1,0,2.7,2596,47
georgia_rule,3.8,116,20,96,17,3.4,30,2,28,6,3,64056,55
kids-of-the-round-table,0,0,0,0,0,0,0,0,0,0,0,0,0
1066169-home_for_the_holidays,6,44,28,16,63,5.7,11,5,6,45,3.4,3045,69
il_postino,7.9,25,23,2,92,0,4,4,0,100,4.1,5794,92
confessional,0,1,1,0,100,0,0,0,0,0,0,0,0
indian_in_the_cupboard,6.2,19,13,6,68,0,2,1,1,50,2.7,5127,41
1101753-eye,0,0,0,0,0,0,0,0,0,0,0,0,0
mr_hollands_opus,6.7,26,19,7,73,7.5,6,5,1,83,3.5,9569,79
dont_be_a_menace,4.5,24,7,17,29,5.6,7,3,4,42,0,0,0
two_if_by_sea,3.9,27,3,24,11,0,4,0,4,0,2.6,1608,29
biodome,1.9,21,1,20,4,2,7,0,7,0,2.6,8972,51
lawnmower_man_2_jobes_war,2.8,9,1,8,11,0,3,1,2,33,2.1,952,18
two-bits,5,10,4,6,40,0,4,1,3,25,3.3,685,54
french_twist,6.1,10,5,5,50,0,4,1,3,25,3.4,597,58
nothing_funny,0,0,0,0,0,0,0,0,0,0,0,0,0
from_dusk_till_dawn,6,43,27,16,62,4.9,10,5,5,50,3.4,36073,75
1065868-fair_game,2.4,24,3,21,12,3.1,8,1,7,12,2.1,1761,16
kicking_and_screaming,5.1,137,57,80,41,5,31,12,19,38,3,14260,51
1083326-les_miserables,6.9,41,31,10,75,6.6,11,6,5,54,3.6,7310,81
bed_of_roses,5.3,14,3,11,21,5.2,5,1,4,20,3.2,3163,66
big_bully,2.8,7,0,7,0,0,2,0,2,0,2.4,1459,23
1069696-screamers,4.7,30,9,21,30,4.9,9,2,7,22,3,2070,45
nico_icon,7.1,13,11,2,84,8,5,4,1,80,4,87,85
crossing_guard,6.5,27,20,7,74,0,4,2,2,50,3.3,2170,56
juror,4.4,19,3,16,15,4.3,6,1,5,16,2.8,2266,39
white_balloon,6.8,20,16,4,80,6.6,8,6,2,75,4,547,86
things_to_do_in_denver_when_youre_dead,4.9,27,9,18,33,5.5,5,1,4,20,3.5,3197,72
antonias_line,6.5,25,16,9,64,7.8,10,9,1,90,4.2,1707,90
once-upon-a-timewhen-we-were-colored,7.3,14,10,4,71,7.9,5,5,0,100,3.7,414,76
last_summer_in_the_hamptons,5.6,15,9,6,60,0,2,2,0,100,3.3,89,47
angels_and_insects,6.5,20,14,6,70,8.1,5,5,0,100,3.3,635,62
white_squall,5.8,30,19,11,63,6.3,10,7,3,70,3.2,3184,62
dunston_checks_in,3.8,15,1,14,6,0,4,1,3,25,2.5,2935,39
black_sheep,6.4,87,61,26,70,6.3,21,15,6,71,3.2,19454,54
nick_of_time,4.6,28,8,20,28,3.8,5,0,5,0,3.1,10563,54
journey_of_august_king,6.2,7,4,3,57,0,2,1,1,50,3.1,286,54
mary_reilly,4.4,41,11,30,26,4.6,9,2,7,22,2.8,3733,41
vampire_in_brooklyn,3.6,28,3,25,10,3.1,9,0,9,0,2.4,6122,37
beautiful_girls,7,46,36,10,78,6.3,14,9,5,64,3.6,4674,79
1069241-broken_arrow,5.8,29,16,13,55,6.1,6,3,3,50,2.9,12489,51
midwinters_tale,7.3,19,17,2,89,0,3,2,1,66,4.1,309,88
hate,8,14,14,0,100,0,4,4,0,100,4.3,11987,95
going_shopping,5,29,12,17,41,5,15,5,10,33,2.8,691,37
heidi_fleiss_hollywood_madam,7.5,7,5,2,71,8.8,5,4,1,80,3,281,46
city_hall,6.1,22,12,10,54,7,6,3,3,50,3,2730,42
bottle_rocket,6.6,42,33,9,78,6.1,9,5,4,55,3.7,16217,80
mr_wrong,3.1,28,1,27,3,3.1,8,0,8,0,2.4,1544,29
unforgettable,4.4,26,6,20,23,0,4,0,4,0,3,358,36
happy_gilmore,5.5,50,29,21,58,5.1,11,4,7,36,3.7,114875,83
bridges_of_madison_county,7.2,40,36,4,90,7.9,9,9,0,100,3.6,11573,83
nobody_loves_me,6,6,4,2,66,0,1,1,0,100,4.2,161,89
muppet_treasure_island,6.1,22,15,7,68,7.4,5,4,1,80,3.2,8588,68
1065684-braveheart,7,48,37,11,77,6.7,16,12,4,75,3.8,204275,83
taxi_driver,8.7,50,49,1,98,7.7,9,8,1,88,4.1,58145,93
rumble_in_the_bronx,6.4,52,41,11,78,6.5,16,13,3,81,3.1,7517,62
1070061-before_and_after,4.8,19,6,13,31,5.7,5,2,3,40,3,1276,39
margarets_museum,6.9,6,4,2,66,0,1,1,0,100,3.7,500,76
happiness_is_in_the_field,0,0,0,0,0,0,0,0,0,0,0,0,0
anne_frank_remembered,7.8,27,26,1,96,7.6,16,15,1,93,3.7,1076,79
young_poisoners_handbook,7.1,13,11,2,84,0,3,3,0,100,3.7,541,79
if_lucy_fell,4,26,5,21,19,4.3,9,2,7,22,3.1,1202,49
steal_big_steal_little,4.5,13,2,11,15,0,3,0,3,0,2.9,555,36
race_the_sun,4.8,9,2,7,22,0,3,0,3,0,2.9,822,40
the-boys-of-st-vincent,8.2,6,6,0,100,0,1,1,0,100,3.5,401,77
1039796-boomerang,4.8,27,10,17,37,5.4,8,4,4,50,2.8,4751,55
chungking_express,7.7,27,26,1,96,6.8,7,6,1,85,4.2,11068,93
star_maker,6.5,12,9,3,75,7,5,4,1,80,3.7,543,73
flirting_with_disaster,7.4,42,36,6,85,8.5,6,6,0,100,3.3,2127,65
neverending_story_3_the_escape_from_fantasia,0,3,1,2,33,0,0,0,0,0,0,0,0
jupiters_wife,0,4,3,1,75,0,1,0,1,0,0,0,0
pie_in_the_sky,0,2,1,1,50,0,0,0,0,0,0,0,0
angelas_ashes,5.7,84,44,40,52,5.3,26,10,16,38,3.6,4588,79
frankie_starlight,5.8,6,4,2,66,0,1,1,0,100,3.8,133,61
curse_of_the_jade_scorpion,5.2,122,55,67,45,5,36,14,22,38,3.1,4108,52
sonic_outlaws,0,3,2,1,66,0,0,0,0,0,0,0,0
down_periscope,3.8,31,4,27,12,4,8,1,7,12,2.8,3851,60
from_the_journals_of_jean_seberg,7.6,9,9,0,100,0,3,3,0,100,4,30,75
man_of_the_year,4.4,141,30,111,21,5,35,11,24,31,3,29127,51
hard_target,5.2,29,14,15,48,5.6,7,4,3,57,0,0,0
up_close_and_personal,5.1,31,10,21,32,6.5,6,3,3,50,3.2,2932,63
birdcage,6.7,29,22,7,75,7.5,5,5,0,100,3.3,13502,75
brothers_mcmullen,7.1,34,31,3,91,7.8,6,6,0,100,3.2,1225,55
1062483-bad_boys,4.8,41,16,25,39,3.7,9,1,8,11,3.5,67658,79
amazing_panda_adventure,4.3,9,2,7,22,0,3,1,2,33,3,1335,46
basketball_diaries,4.9,35,15,20,42,4.7,11,3,8,27,3.5,12119,77
awfully_big_adventure,5.4,11,4,7,36,0,3,0,3,0,3.2,1433,55
the-amateurs,3.9,24,4,20,16,0,4,1,3,25,3,8865,46
apollo_13,8,51,49,2,96,7.9,11,10,1,90,3.6,30565,78
1061000-rob_roy,6.3,42,30,12,71,5.8,10,5,5,50,3.3,5253,73
basic_instinct_2,3.1,149,10,139,6,3.2,35,1,34,2,2.5,28208,33
batman_forever,5.2,54,23,31,42,5.9,14,10,4,71,2.9,47498,42
belle_de_jour,8.6,36,34,2,94,7.9,9,8,1,88,4,1378,84
beyond_rangoon,5.1,30,11,19,36,5,10,4,6,40,3.5,3962,64
blue_in_the_face,5.5,20,9,11,45,0,3,1,2,33,3.5,1323,73
canadian_bacon,3.3,14,2,12,14,0,2,0,2,0,2.9,3460,49
casper,4.7,34,14,20,41,4.5,10,3,7,30,3,20672,54
clockers,6.5,46,31,15,67,6.7,12,9,3,75,3.5,2502,74
congo,3.6,42,9,33,21,3.2,12,1,11,8,2.6,7008,34
crimson_tide,7.4,44,38,6,86,8,10,9,1,90,3.5,11550,77
crumb,8.3,39,37,2,94,0,4,4,0,100,4,2689,88
desperado,6.3,38,23,15,60,5.4,10,3,7,30,3.5,23821,79
devil_in_a_blue_dress,7.3,50,44,6,88,7,14,11,3,78,3.3,2742,64
die_hard_with_a_vengeance,5.7,42,20,22,47,5.8,10,5,5,50,3.6,61394,83
doom_generation,4.9,29,14,15,48,5.3,12,7,5,58,3.3,2680,64
feast_of_july,6.2,9,6,3,66,0,4,2,2,50,2.9,226,40
first_knight,5.2,42,19,23,45,5.5,14,7,7,50,3,13290,59
free_willy_2_the_adventure_home,4.6,12,3,9,25,0,3,1,2,33,2.8,8336,53
hackers,4.7,19,7,12,36,0,3,2,1,66,3.2,16863,66
jeffrey,6.1,23,14,9,60,5.7,9,4,5,44,3.4,836,68
johnny_mnemonic,3.3,28,4,24,14,4.7,5,1,4,20,2.5,7062,33
judge_dredd,3.6,47,7,40,14,3.7,10,0,10,0,2.5,10571,35
jury_duty,2.1,11,0,11,0,0,2,0,2,0,2.4,1843,33
kids,5,52,26,26,50,6.5,7,4,3,57,3.5,11282,78
living_in_oblivion,7.4,24,21,3,87,0,2,2,0,100,3.8,1878,85
lord_of_illusions,5.7,19,13,6,68,0,2,1,1,50,3,2344,51
love-and-human-remains,6.5,11,7,4,63,0,4,2,2,50,0,0,0
bad_love,0,0,0,0,0,0,0,0,0,0,0,0,0
mallrats,5.4,40,21,19,52,5,9,2,7,22,3.6,40221,83
mighty_morphin_power_rangers_the_movie,4.6,19,8,11,42,5.5,8,5,3,62,2.7,5904,52
moonlight_and_valentino,4.6,13,2,11,15,0,3,0,3,0,3.1,978,51
mute_witness,6.9,19,15,4,78,7.3,6,5,1,83,3.2,644,61
the-case-of-the-white-chapel-vampire-the-royal-scandal2001,0,0,0,0,0,0,0,0,0,0,0,0,0
net,5.1,33,11,22,33,6.9,5,3,2,60,2.8,10933,50
nine_months,4.3,24,6,18,25,5,5,1,4,20,2.7,8930,40
1066050-party_girl,6.3,31,24,7,77,6,13,8,5,61,3.5,1243,73
1065632-prophecy,5.2,19,8,11,42,0,1,0,1,0,3.3,5062,71
reckless_moment,0,3,3,0,100,0,0,0,0,0,0,0,0
failsafe,7.6,13,12,1,92,0,0,0,0,0,0,0,0
1066120-scarlet_letter,3,33,5,28,15,3.6,11,1,10,9,2.9,3493,48
showgirls,2.9,41,5,36,12,3.4,10,0,10,0,2.3,7443,35
1062983-smoke,7.8,27,25,2,92,0,4,3,1,75,3.9,3101,88
something_to_talk_about,5.3,27,10,17,37,6.5,9,5,4,55,3,6137,55
species,4.9,31,12,19,38,5.1,5,1,4,20,2.7,6716,37
stars_fell_on_henrietta,4.9,7,2,5,28,0,1,0,1,0,3,66,18
strange_days,6,38,23,15,60,5.9,8,4,4,50,3.3,7016,70
umbrellas_of_cherbourg,8.6,45,44,1,97,7.9,10,9,1,90,4.1,3199,86
tie_that_binds,2.8,9,1,8,11,0,3,0,3,0,3,286,34
three_wishes,4.4,15,2,13,13,0,4,0,4,0,3,1249,52
total_eclipse,4.9,16,4,12,25,0,4,1,3,25,3.4,2222,63
to_wong_foo_thanks_for_everything_julie_newmar,5,23,8,15,34,5.2,5,0,5,0,3.1,6833,69
under_siege_2_dark_territory,4.5,29,10,19,34,0,3,2,1,66,2.6,5213,47
unstrung_heroes,6.3,21,16,5,76,0,4,2,2,50,3.2,530,54
unzipped,6.7,13,10,3,76,7.9,5,5,0,100,3.3,64,67
walk_in_the_clouds,5.5,22,9,13,40,0,3,1,2,33,3.3,12692,74
waterworld,5.1,48,20,28,41,6.4,9,7,2,77,2.6,18023,46
1067214-white_mans_burden,4.5,32,8,24,25,4.4,10,1,9,10,2.8,1275,38
1043923-browning_version,7.8,17,15,2,88,0,3,1,2,33,4.3,270,94
bushwhacked,2.1,9,0,9,0,0,2,0,2,0,2.6,1388,38
burnt_by_the_sun,7,13,10,3,76,0,4,3,1,75,4.3,1533,93
before_the_rain,7.5,12,10,2,83,0,2,2,0,100,4.4,1683,93
before_sunrise,8.2,34,34,0,100,9.3,5,5,0,100,4.1,20616,92
billy_madison,4.8,35,15,20,42,0,4,1,3,25,3.5,91595,79
babysitters,4.4,26,8,18,30,4.6,12,3,9,25,2.9,1237,35
boys_on_the_side,6,32,23,9,71,6.1,8,5,3,62,3.1,4572,65
1061860-cure,5.5,10,4,6,40,0,4,1,3,25,3.7,2207,79
castle_freak,5.4,7,4,3,57,0,0,0,0,0,0,0,0
1059480-circle_of_friends,6.5,35,27,8,77,6.5,11,8,3,72,3.3,3292,65
clerks,7.4,48,42,6,87,7.1,9,8,1,88,3.8,57642,89
don-juan-demarco,5.8,22,16,6,72,0,2,1,1,50,3.3,14169,70
disclosure,5.7,40,24,16,60,5.8,9,5,4,55,2.8,3648,41
tucker_the_man_and_his_dream,7.2,35,30,5,85,6.8,7,5,2,71,3.2,1497,58
drop_zone,4.1,19,6,13,31,0,3,1,2,33,2.7,2485,36
destiny_turns_on_the_radio,2.7,15,2,13,13,0,2,0,2,0,2.6,446,27
death_and_the_maiden,7,48,40,8,83,6.2,10,7,3,70,3.6,1972,76
dolores_claiborne,6.8,33,28,5,84,0,4,3,1,75,3.4,4632,75
dumb_and_dumber,5.8,45,28,17,62,4.8,10,4,6,40,3.3,95871,79
eat_drink_man_woman,7.4,31,29,2,93,7.9,8,8,0,100,4,3802,91
exotica,8.3,27,26,1,96,0,3,3,0,100,3.7,1837,81
exit_to_eden,2.4,15,1,14,6,0,3,0,3,0,2.3,1694,27
ed_wood,7.9,57,52,5,91,7.2,12,9,3,75,3.7,28216,83
french_kiss,5.7,21,10,11,47,0,4,1,3,25,3.2,11010,70
forget_paris,5.4,33,17,16,51,4.7,8,2,6,25,3,2108,51
far_from_home_the_adventures_of_yellow_dog,5.2,6,3,3,50,0,0,0,0,0,0,0,0
goofy_movie,5.7,14,8,6,57,0,2,1,1,50,3.1,17024,57
1060518-hideaway,3.5,12,2,10,16,0,4,1,3,25,2.8,1077,41
fluke,4,9,3,6,33,0,3,0,3,0,3.4,1598,70
farinelli,5.7,21,14,7,66,4.7,6,2,4,33,3.8,1092,81
1007517-flash_gordon,6.3,32,26,6,81,0,3,2,1,66,3.1,6492,64
gumby_the_movie,0,4,0,4,0,0,0,0,0,0,0,0,0
glass_shield,5.6,21,13,8,61,5.2,7,3,4,42,3,263,41
hoop_dreams,8.5,44,43,1,97,8.1,12,12,0,100,4.1,3243,92
heavenly_creatures,8.3,41,39,2,95,7.8,9,9,0,100,3.7,8208,82
houseguest,3.4,20,3,17,15,5.2,5,3,2,60,2.8,1745,51
immortal_beloved,6,30,17,13,56,0,3,2,1,66,3.8,4786,87
1059860-heavyweights,4.1,5,1,4,20,0,0,0,0,0,0,0,0
1120843-hunted,4.7,143,44,99,30,4.5,34,10,24,29,3,5362,51
iq,5.1,21,9,12,42,0,3,1,2,33,2.8,3758,46
interview_with_the_vampire,5.8,45,26,19,57,4.6,10,4,6,40,3.7,77706,85
jefferson_in_paris,4.9,14,5,9,35,0,3,1,2,33,2.8,404,27
jerky_boys_the_the_movie,1.6,10,1,9,10,0,0,0,0,0,0,0,0
1058426-junior,4.7,30,10,20,33,5.8,8,5,3,62,2.4,9754,28
just_cause,4,26,6,20,23,4.2,8,2,6,25,3.1,2888,51
kid_in_king_arthurs_court,3.2,6,0,6,0,0,0,0,0,0,0,0,0
1060720-kiss_of_death,6.4,36,24,12,66,7.2,12,9,3,75,2.9,2125,39
star_wars,8.2,64,60,4,93,7.4,17,15,2,88,4.1,147448,93
1190049-little_women,0,0,0,0,0,0,0,0,0,0,0,0,0
1061812-little_princess,8.4,20,19,1,95,0,3,3,0,100,3.4,13643,81
ladybird_ladybird,7.2,6,4,2,66,0,2,2,0,100,4,368,87
1059177-lenfer,7.9,8,8,0,100,0,1,1,0,100,3.5,421,67
like_water_for_chocolate,7.6,28,25,3,89,0,3,3,0,100,3.9,5713,86
chris-smither-one-more-night2007,0,0,0,0,0,0,0,0,0,0,0,0,0
major_payne,4.6,10,3,7,30,0,2,1,1,50,2.9,8555,69
little_odessa,5.8,17,11,6,64,0,3,1,2,33,3.5,985,69
mi_vida_loca_my_crazy_life,6.6,15,12,3,80,0,3,2,1,66,3.9,2251,81
1056341-love_affair,4.8,26,8,18,30,0,3,1,2,33,3.5,1260,71
losing_isaiah,5.1,28,12,16,42,5,9,4,5,44,3.6,2364,76
madness_of_king_george,7.8,42,39,3,92,8.1,10,10,0,100,3.6,1886,76
1007818-frankenstein,8.5,38,38,0,100,7.8,5,5,0,100,3.6,7211,81
man_of_the_house,3.3,60,5,55,8,3.9,16,4,12,25,3.1,10877,59
mixed_nuts,2.8,28,2,26,7,2.5,6,0,6,0,2.9,2410,46
1055255-milk_money,2.6,25,1,24,4,2.5,8,0,8,0,2.7,2126,40
1013970-miracle_on_34th_street,8,31,29,2,93,0,2,2,0,100,3.5,5409,81
miami_rhapsody,6.1,18,8,10,44,0,3,2,1,66,2.6,766,28
my_family,7.2,11,9,2,81,0,3,3,0,100,3.9,1137,85
murder_in_the_first,5.5,34,17,17,50,4.8,10,4,6,40,3.5,3888,78
1015224-nobodys_fool,0,4,0,4,0,0,1,0,1,0,3,289,43
nell,5,31,16,15,51,0,3,3,0,100,3.1,5373,63
new_jersey_drive,6.5,7,4,3,57,0,3,2,1,66,3.8,814,81
new_york_cop,0,0,0,0,0,0,0,0,0,0,0,0,0
nightscare,0,1,0,1,0,0,0,0,0,0,0,0,0
nemesis_2,0,0,0,0,0,0,0,0,0,0,0,0,0
nina_takes_a_lover,5.2,6,3,3,50,0,2,0,2,0,3.4,125,52
natural_born_killers,6,29,15,14,51,5.9,7,3,4,42,3.5,39062,80
1055875-only_you,5.5,22,11,11,50,0,3,1,2,33,3.3,4388,69
once_were_warriors,7.7,31,29,2,93,7.4,8,7,1,87,0,0,0
poison_ivy_2_lily,3.8,6,1,5,16,0,0,0,0,0,0,0,0
outbreak,5.6,41,24,17,58,5.1,10,4,6,40,3.1,10732,55
professional,6.8,39,30,9,76,5.8,8,4,4,50,4.1,59011,94
perez_family,6.3,15,10,5,66,5.9,5,2,3,40,3.2,500,50
pyromaniacs_love_story,3.4,9,0,9,0,0,2,0,2,0,3.1,773,44
pulp_fiction,8.9,50,47,3,94,8.4,14,13,1,92,4.2,249269,95
pink_panther_2,3.5,128,16,112,12,3.9,25,4,21,16,3.1,77879,48
pushing_hands,0,2,2,0,100,0,0,0,0,0,0,0,0
1063814-1063814-priest,7.2,19,13,6,68,0,4,3,1,75,3.8,1042,81
quiz_show,8.1,50,48,2,96,8.2,12,12,0,100,3.5,5428,79
picture_bride,6.8,10,8,2,80,0,3,3,0,100,3.7,324,77
queen_margot,5.9,22,17,5,77,0,2,1,1,50,4,2511,86
1059629-quick_and_the_dead,5.9,39,22,17,56,4.2,8,1,7,12,3.1,12178,56
roommates,5.1,13,4,9,30,0,2,0,2,0,3.2,387,51
ready_to_wear,4.8,21,6,15,28,4.3,5,0,5,0,2.5,1885,26
1058966-red,8.5,40,40,0,100,8.2,10,10,0,100,4.2,9557,94
1049109-blue,8.4,32,32,0,100,8,5,5,0,100,4.2,11731,93
white,7.5,31,28,3,90,7.6,9,9,0,100,3.9,5105,86
red_firecracker_green_firecracker,0,4,3,1,75,0,1,0,1,0,4.6,71,100
rentakid,0,0,0,0,0,0,0,0,0,0,0,0,0
stuart_saves_his_family,4.6,25,7,18,28,5.2,10,3,7,30,2.6,531,44
swan_princess,5.3,9,4,5,44,0,3,2,1,66,3.1,5951,66
the-secret-of-roan-inish,7.8,40,39,1,97,7.5,12,11,1,91,3.9,1439,86
1056079-specialist,3.1,24,1,23,4,3.8,5,0,5,0,2.5,5147,34
stargate,5.2,37,17,20,45,0,4,1,3,25,3.3,23611,75
santa_claus_the_movie,4.1,17,3,14,17,0,1,0,1,0,3.1,2513,66
shawshank_redemption,8,57,50,7,87,7.9,11,10,1,90,4.4,168839,98
1058923-shallow_grave,6.4,42,30,12,71,5.4,10,5,5,50,3.6,9041,81
suture,6.2,11,7,4,63,0,3,0,3,0,3.6,236,74
strawberry_and_chocolate,6.6,19,15,4,78,0,2,2,0,100,3.9,848,83
swimming_with_sharks,6.3,33,25,8,75,5.4,10,5,5,50,3.6,2888,78
sum_of_us,6.5,13,9,4,69,0,2,1,1,50,3.6,1056,74
national_lampoons_senior_trip,2.6,7,0,7,0,0,1,0,1,0,3,1370,53
huozhe-to-live-lifetimes-living,8.1,14,12,2,85,0,3,3,0,100,4.3,1836,95
tank_girl,4.9,33,14,19,42,5.3,9,4,5,44,2.8,7013,61
tales_from_the_crypt_presents_demon_knight,4,23,7,16,30,3.4,7,1,6,14,3.2,4989,63
star_trek_generations,5.5,44,20,24,45,6.4,9,6,3,66,3.3,15342,62
tales_from_the_hood,4.3,15,5,10,33,0,2,1,1,50,3.1,2119,58
tom_and_viv,4.8,11,4,7,36,0,2,1,1,50,3.4,351,59
1061401-village_of_the_damned,4,30,9,21,30,4.2,5,2,3,40,2.7,4194,36
tommy_boy,5.2,38,17,21,44,3.6,6,1,5,16,3.6,34476,89
vanya_on_42nd_street,7.6,32,28,4,87,7.7,9,8,1,88,3.7,466,73
underneath,5.7,19,10,9,52,5.8,8,3,5,37,3,405,36
nightmare_city,0,4,2,2,50,0,0,0,0,0,0,0,0
whats_eating_gilbert_grape,7.3,42,37,5,88,5.8,9,6,3,66,3.7,57512,86
virtuosity,4.3,29,10,19,34,4,8,2,6,25,2.8,4167,37
while_you_were_sleeping,6.5,41,35,6,85,6.5,13,11,2,84,3.2,25923,75
the-secret-war,0,0,0,0,0,0,0,0,0,0,0,0,0
double_happiness,7,10,7,3,70,0,2,2,0,100,3.4,627,61
muriels_wedding,7.1,32,29,3,90,0,4,4,0,100,3.4,8356,78
babysitters_club_the_movie,6,15,9,6,60,6.1,7,3,4,42,2.9,1930,46
ace_ventura_pet_detective,4.6,37,18,19,48,0,2,0,2,0,3.1,163811,57
adventures_of_priscilla_queen_of_the_desert,7,29,27,2,93,7,6,5,1,83,3.7,8695,84
backbeat,6.2,34,25,9,73,6.5,9,6,3,66,3.3,926,67
bitter-moon,6.2,29,19,10,65,4.7,8,3,5,37,3.8,3436,79
bullets_over_broadway,7.9,54,52,2,96,8.2,12,12,0,100,3.6,3913,79
clear_and_present_danger,6.8,37,29,8,78,7.1,9,7,2,77,3.3,11095,69
client,6.1,35,28,7,80,6.2,7,5,2,71,3.3,7408,67
corrina_corrina,5.2,16,6,10,37,0,3,0,3,0,3.1,4265,65
crooklyn,6.6,24,18,6,75,6.8,7,6,1,85,4.1,3115,87
crow,7,40,33,7,82,6.9,8,6,2,75,3.8,64467,87
cobb,6.2,32,21,11,65,5.2,8,4,4,50,3.2,875,57
1051663-flintstones,3.7,40,8,32,20,4.5,7,2,5,28,2.5,11823,35
forrest_gump,6.9,53,37,16,69,7,13,9,4,69,4.1,205253,93
four_weddings_and_a_funeral,7.5,49,47,2,95,7.3,9,8,1,88,3.2,21524,68
higher_learning,5.3,34,17,17,50,4.6,11,4,7,36,3.5,4026,77
i_like_it_like_that,7.4,9,7,2,77,0,3,3,0,100,4,625,85
1054344-it_could_happen_to_you,6.2,34,23,11,67,6.2,8,6,2,75,3,6180,53
1031385-jungle_book,7.3,27,24,3,88,0,2,1,1,50,3.5,35715,70
wonderful_horrible_life_of_leni_riefenstahl,7.6,22,21,1,95,0,4,3,1,75,3.7,257,81
lion_king,8,61,56,5,91,7.8,13,13,0,100,3.9,127550,89
little_buddha,5.8,22,14,8,63,6.4,7,4,3,57,3.1,2898,50
wes_cravens_new_nightmare,6.6,31,25,6,80,6.3,9,7,2,77,3.2,11902,65
1053779-mask,6.4,44,33,11,75,6.1,9,5,4,55,3.2,68419,66
maverick,6,37,26,11,70,7.4,6,6,0,100,3.2,11507,68
mrs_parker_and_the_vicious_circle,6.3,24,17,7,70,0,3,2,1,66,3.5,634,62
naked_gun_33_13_the_final_insult,5.6,32,17,15,53,7,7,6,1,85,2.9,10482,59
paper,6.7,31,27,4,87,6.9,7,6,1,85,3.1,1357,54
reality_bites,6,42,27,15,64,6.1,9,5,4,55,3.3,10533,74
red_rock_west,7.5,37,35,2,94,7.2,8,7,1,87,0,0,0
richie_rich,4.2,20,5,15,25,4.8,5,2,3,40,2.5,10242,38
safe_passage,5.8,12,6,6,50,0,3,1,2,33,3.4,310,59
river_wild,5.8,27,15,12,55,5.8,6,3,3,50,2.9,5610,50
1052692-1052692-speed,7.6,41,37,4,90,7.1,9,7,2,77,3.3,51008,72
speechless,3.9,25,3,22,12,3.8,6,0,6,0,2.8,683,34
timecop,5.3,38,18,20,47,5.1,9,4,5,44,2.6,6534,38
true_lies,6.4,45,31,14,68,5.4,9,5,4,55,3.2,27905,70
when_a_man_loves_a_woman,6.5,19,13,6,68,0,3,2,1,66,3.3,6791,76
1053942-wolf,5.9,48,29,19,60,5.9,8,5,3,62,2.8,6634,43
1052698-wyatt_earp,5.3,26,11,15,42,0,3,0,3,0,3.2,8070,63
1114548-bad_company,3.9,134,14,120,10,4,31,5,26,16,2.8,6415,42
man_of_no_importance,7,12,10,2,83,0,3,2,1,66,3.6,111,62
sfw,3.2,16,2,14,12,0,2,0,2,0,3,1184,49
low_down_dirty_shame,3.6,20,0,20,0,3.5,6,0,6,0,2.9,3460,58
this_boys_life,6.3,34,26,8,76,5,10,4,6,40,3.5,5072,76
1058427-colonel_chabert,7.1,6,5,1,83,0,1,1,0,100,3.6,142,59
faster_pussycat_kill_kill,6.9,25,18,7,72,0,3,2,1,66,3.8,3351,77
jasons_lyric,6,14,10,4,71,0,3,2,1,66,4,2470,87
secret_adventures_of_tom_thumb,6.3,5,4,1,80,0,0,0,0,0,0,0,0
1058516-street_fighter,2.9,24,3,21,12,0,4,0,4,0,2.2,10305,25
1010448-in_cold_blood,8.3,25,22,3,88,7.8,5,4,1,80,3.8,2614,83
desert_winds,4.3,9,2,7,22,4.5,6,2,4,33,4,36,100
fall_time,0,3,0,3,0,0,0,0,0,0,0,0,0
1037581-cape_fear,6.9,38,29,9,76,8.3,6,6,0,100,3.4,13943,74
frank-and-ollie,7.3,8,7,1,87,0,1,1,0,100,3.9,177,83
1013976-mirage,0,3,2,1,66,0,0,0,0,0,0,0,0
open_season,5.4,98,46,52,46,5.7,24,13,11,54,3.4,91895,66
brother_minister,0,1,1,0,100,0,1,1,0,100,4.2,76,90
highlander1994,0,0,0,0,0,0,0,0,0,0,0,0,0
federal_hill,6.4,15,12,3,80,6.2,9,6,3,66,3,131,41
in_the_mouth_of_madness,5,29,14,15,48,4.6,7,2,5,28,3.5,5731,73
8_seconds,5.2,12,4,8,33,0,2,0,2,0,3.6,7861,89
above_the_rim,5.4,18,10,8,55,5,6,3,3,50,3.5,4319,84
addams_family_values,6.3,35,26,9,74,5.5,7,4,3,57,3.1,21548,57
airheads,4.2,31,7,24,22,4.6,8,3,5,37,2.9,13551,51
air_up_there,4,26,6,20,23,3,6,0,6,0,2.6,2385,33
another_stakeout,3.9,21,3,18,14,0,3,1,2,33,2.5,1861,31
1051219-bad_girls,3.5,21,2,19,9,0,4,0,4,0,2.8,5946,49
vicky_cristina_barcelona,6.9,188,154,34,81,7.2,35,29,6,82,3.6,45494,73
1046435-beverly_hillbillies,3.6,28,7,21,25,4.2,8,3,5,37,2.5,4897,40
beverly_hills_cop_3,3.3,30,3,27,10,2.9,6,0,6,0,2.9,12777,50
1126533-black_friday,0,0,0,0,0,0,0,0,0,0,0,0,0
1052838-blown_away,4.8,18,5,13,27,0,3,0,3,0,2.9,3591,46
blue_chips,5.1,26,10,16,38,4.6,8,3,5,37,3,1545,50
blue-sky,6.3,18,13,5,72,0,3,2,1,66,3.2,809,52
1010678-invasion_of_the_body_snatchers,8.9,36,36,0,100,0,2,2,0,100,3.6,3820,81
boxing_helena,3.7,30,6,24,20,3.4,7,1,6,14,2.6,1775,39
bronx_tale,7.4,26,25,1,96,0,3,3,0,100,3.9,17840,89
cabin_boy,4.9,23,10,13,43,0,2,0,2,0,2.4,1694,36
calendar_girls,6.5,118,87,31,73,6.5,33,23,10,69,3.1,8453,59
carlitos_way,6.8,33,27,6,81,0,4,2,2,50,3.8,32475,88
city_slickers_ii_the_legend_of_curlys_gold,3.6,21,4,17,19,0,3,0,3,0,2.7,5885,34
1050560-clean_slate,4.1,16,3,13,18,0,2,0,2,0,2.5,630,33
1044214-cliffhanger,6.3,33,27,6,81,6.2,7,5,2,71,2.8,9768,47
coneheads,4.5,27,9,18,33,4.7,8,3,5,37,2.6,9202,37
color_of_night,3.9,26,8,18,30,0,3,0,3,0,2.7,3955,40
cops_and_robbersons,3.5,19,3,16,15,2.6,6,0,6,0,2.5,1201,26
cowboy_way,4.2,12,2,10,16,0,2,0,2,0,3,2782,61
dave,7.4,37,36,1,97,7.5,9,9,0,100,3.1,4985,63
dazed_and_confused,7.9,41,40,1,97,7.6,7,6,1,85,3.8,45956,89
demolition_man,5.6,32,20,12,62,4.2,8,3,5,37,3,16135,60
endless_summer_ii_the_the_journey_continues,5.8,14,8,6,57,5,5,2,3,40,4,802,89
even_cowgirls_get_the_blues,3.2,17,4,13,23,0,3,0,3,0,2.6,1583,31
1046049-fatal_instinct,4.2,20,4,16,20,3.6,8,1,7,12,2.6,808,36
farewell_to_my_concubine,7.4,33,29,4,87,7.2,10,8,2,80,4.1,4321,91
favor,4.9,10,3,7,30,0,3,0,3,0,2.8,891,23
fearless-a-chinese-hero,0,0,0,0,0,0,0,0,0,0,0,0,0
fear_of_a_black_hat,7,19,16,3,84,7.2,8,8,0,100,3.8,898,81
with_honors,4,21,4,17,19,0,3,0,3,0,3.3,3484,72
flesh_and_bone,6.1,23,16,7,69,0,3,1,2,33,3,851,40
widows_peak,7.1,15,15,0,100,0,3,3,0,100,3.2,348,46
1044522-firm,6.2,50,38,12,76,5,9,4,5,44,3.2,11507,61
free_willy,5.5,21,11,10,52,0,3,2,1,66,2.9,19451,48
fresh,7.5,19,17,2,89,0,3,3,0,100,4,1823,90
1046129-fugitive,7.6,52,49,3,94,8,9,9,0,100,3.6,28862,82
geronimo_an_american_legend,6.2,17,9,8,52,0,3,1,2,33,3.2,1686,53
a_perfect_getaway,5.8,124,76,48,61,5.9,29,18,11,62,3.2,102622,50
getting_even_with_dad,3.3,12,1,11,8,0,3,0,3,0,2.4,2200,29
1062542-go_fish,6.6,13,10,3,76,7.4,5,4,1,80,3.2,898,54
good_man_in_africa,4.4,8,1,7,12,0,2,0,2,0,2.9,306,34
guilty_as_sin,5.2,13,5,8,38,0,3,2,1,66,2.8,474,30
hard_target,5.2,29,14,15,48,5.6,7,4,3,57,0,0,0
1048333-heaven_and_earth,5.2,17,8,9,47,5.8,5,2,3,40,3.6,1458,71
hot_shots_part_deux,5.6,28,17,11,60,5.8,6,3,3,50,3,9890,61
live_nude_girls,4.4,8,3,5,37,0,1,1,0,100,3.2,368,46
englishman_who_went_up_a_hill_but_came_down_a_mountain,5.8,22,13,9,59,7,5,4,1,80,3,3033,50
house_of_the_spirits,5.4,14,6,8,42,0,3,1,2,33,3.7,3169,74
house_party_3,2.7,6,0,6,0,0,0,0,0,0,0,0,0
hudsucker_proxy,6.2,38,22,16,57,4.1,9,2,7,22,3.6,10291,80
ill_do_anything,5.2,17,10,7,58,0,3,3,0,100,3,481,40
in_the_army_now,2.2,21,0,21,0,2.5,5,0,5,0,2.5,3672,47
in_the_line_of_fire,7.6,41,39,2,95,8.3,7,6,1,85,3.4,7831,72
in_the_name_of_the_father,7.6,39,37,2,94,7.4,9,8,1,88,4,10715,92
inkwell,5,7,2,5,28,0,2,1,1,50,3.8,507,78
whats_love_got_to_do_with_it,7.5,33,32,1,96,8.2,7,7,0,100,3.6,9612,83
jimmy_hollywood,4.1,20,3,17,15,0,3,0,3,0,2.5,544,24
judgment_night,4.2,15,4,11,26,3.2,5,1,4,20,3.1,2059,53
jurassic_park,7.2,38,33,5,86,7.1,10,9,1,90,3.6,91260,81
kalifornia,6.2,24,16,8,66,0,2,1,1,50,3.2,9852,63
killing_zoe,5.1,25,10,15,40,0,2,0,2,0,3.4,3407,65
1046045-king_of_the_hill,7.9,25,24,1,96,7.8,7,6,1,85,3.6,963,77
1053155-lassie,6.8,8,6,2,75,0,2,2,0,100,2.9,2576,52
last_action_hero,4.9,37,14,23,37,4.6,5,1,4,20,2.6,11445,43
life_with_mikey,3.9,9,2,7,22,0,2,0,2,0,2.8,1377,39
lightning_jack,3.4,16,1,15,6,3.9,6,1,5,16,2.8,2199,43
the-thistle-and-the-lotus,0,0,0,0,0,0,0,0,0,0,0,0,0
1043960-made_in_america,3.9,28,8,20,28,0,3,1,2,33,2.5,4179,38
malice,5.8,18,10,8,55,0,3,0,3,0,3,2429,42
man_without_a_face,5.7,20,12,8,60,0,3,2,1,66,3.1,5277,63
manhattan_murder_mystery,6.9,21,19,2,90,0,3,3,0,100,3.7,4405,81
menace_ii_society,7.4,34,29,5,85,8,8,7,1,87,3.8,14420,88
executive_decision,6,37,24,13,64,6.3,10,6,4,60,2.9,5176,51
in_the_realm_of_the_senses,7.5,28,23,5,82,0,1,1,0,100,3.5,1565,67
what_happened_was,7,20,18,2,90,0,4,3,1,75,4.1,120,84
1045992-much_ado_about_nothing,7.1,41,37,4,90,6.8,8,6,2,75,3.6,9764,82
mr_jones,5.2,13,6,7,46,0,2,1,1,50,3,1067,45
mr_wonderful,5.9,18,10,8,55,6.1,5,3,2,60,3.1,870,46
mrs_doubtfire,5.7,42,27,15,64,0,2,1,1,50,3.4,61130,73
1048185-naked,8,21,19,2,90,0,2,2,0,100,4.3,3386,92
next_karate_kid,3.6,17,1,16,5,0,4,0,4,0,0,0,0
new_age,6,11,7,4,63,0,3,2,1,66,3.1,82,40
no_escape,5.1,15,8,7,53,0,3,0,3,0,3,2147,43
north,3,18,2,16,11,0,3,0,3,0,2.6,2932,32
orlando,6.2,26,21,5,80,0,2,1,1,50,3.9,2705,81
perfect_world,7.2,27,22,5,81,7.4,5,4,1,80,3.5,7814,77
philadelphia,6.5,43,32,11,74,6.7,5,4,1,80,3.7,20896,87
piano,8,45,40,5,88,9.3,7,7,0,100,3.7,12303,86
poetic_justice,4.6,14,5,9,35,0,3,1,2,33,3.4,5709,83
program,5,14,5,9,35,0,3,1,2,33,3.6,2842,77
puppet_masters,4.9,22,6,16,27,4,5,0,5,0,2.8,1068,38
radioland_murders,4,15,3,12,20,0,2,0,2,0,3.1,601,52
ref,6.6,41,32,9,78,5.6,8,4,4,50,3.3,3390,73
remains_of_the_day,8.4,38,37,1,97,8.3,8,7,1,87,3.8,6319,86
renaissance_man,4.4,18,3,15,16,0,3,0,3,0,2.9,2575,54
rising_sun,5.1,35,12,23,34,5.2,11,4,7,36,2.9,4796,47
road_to_wellville,4.9,16,7,9,43,0,2,1,1,50,2.8,1442,39
robocop_3,3.1,28,1,27,3,3,6,0,6,0,2.3,6600,21
robin_hood_men_in_tights,5.1,22,10,12,45,0,1,0,1,0,3.5,45946,79
romeo_is_bleeding,4.5,34,8,26,23,3.6,9,0,9,0,3.3,1704,62
romper_stomper,6.2,24,19,5,79,0,4,1,3,25,3.5,11581,72
ruby_in_paradise,7.8,15,14,1,93,0,2,2,0,100,3.8,186,77
rudy,6.8,34,27,7,79,6.7,8,6,2,75,3.7,21916,88
saint_of_fort_washington,6.5,9,6,3,66,0,3,2,1,66,3.9,305,84
les-nuits-fauves-savage-nights,0,0,0,0,0,0,0,0,0,0,0,0,0
schindlers_list,8.8,59,57,2,96,8.4,10,10,0,100,4.3,83125,96
last_boy_scout,5.1,30,13,17,43,0,4,2,2,50,3.3,11177,66
searching_for_bobby_fischer,8.1,33,33,0,100,8.4,8,8,0,100,3.5,3580,81
10003765-second_best,5,16,6,10,37,4.5,8,2,6,25,3,174,37
1045518-secret_garden,8.1,17,16,1,94,0,3,2,1,66,3.3,14794,72
serial_mom,5.8,44,27,17,61,4,8,1,7,12,3,6394,62
kagemusha,7.5,19,16,3,84,0,2,1,1,50,4.2,4005,91
1048267-shadowlands,8,28,27,1,96,8.8,6,6,0,100,3.9,3260,85
short_cuts,7.8,51,48,3,94,8.1,8,7,1,87,3.9,5867,87
simple_twist_of_fate,5.5,19,9,10,47,0,2,0,2,0,3.1,1672,52
sairenforbidden-siren,0,0,0,0,0,0,0,0,0,0,0,0,0
six_degrees_of_separation,7.1,30,27,3,90,0,3,1,2,33,3.3,3720,67
sleepless_in_seattle,6.5,43,31,12,72,5.6,10,6,4,60,3.3,36965,75
sliver,3.6,24,3,21,12,0,2,0,2,0,2.5,2511,34
replikator-cloned-to-kill,0,0,0,0,0,0,0,0,0,0,0,0,0
son_in_law_1993,3.8,17,4,13,23,0,3,0,3,0,2.9,5679,62
so_i_married_an_axe_murderer,5.3,30,15,15,50,5,8,3,5,37,3,11154,66
striking_distance,3.6,19,3,16,15,0,2,0,2,0,2.8,4532,39
1121056-harem,0,1,1,0,100,0,0,0,0,0,0,0,0
surviving_the_game,4.3,13,3,10,23,0,1,0,1,0,3,1673,48
terminal_velocity,3.6,20,3,17,15,0,3,0,3,0,2.6,1883,25
thirty-two-short-films-about-glenn-gould,8,17,15,2,88,0,3,3,0,100,3.8,1129,79
threesome,4.4,23,6,17,26,4.1,6,1,5,16,3,1708,52
nightmare_before_christmas,8.2,70,68,2,97,8.2,17,17,0,100,3.8,124838,89
1046772-three_musketeers,4.8,24,7,17,29,0,3,0,3,0,3.2,13783,67
tombstone,6.4,39,30,9,76,0,3,0,3,0,3.8,31660,93
true_romance,7.5,44,40,4,90,6.2,9,7,2,77,3.9,43205,90
dr_strangelove,9,58,58,0,100,8.6,8,8,0,100,4.2,33662,94
pagemaster,4.6,15,3,12,20,5,6,2,4,33,2.8,7531,49
two_days_in_paris,6.8,113,96,17,84,6.9,34,30,4,88,3.6,27100,71
forbidden_choices,0,3,1,2,33,0,0,0,0,0,0,0,0
killer_movie,0,1,0,1,0,0,0,0,0,0,0,0,0
welcome_to_the_dollhouse,7.9,46,41,5,89,8.1,7,6,1,85,3.7,6911,84
germinal,6.9,10,9,1,90,0,2,2,0,100,3.7,511,71
chaser,6.7,27,22,5,81,6.8,5,4,1,80,4,1927,88
cronos,7.3,35,31,4,88,7.8,7,6,1,85,3.5,3398,68
naked_in_new_york,6.1,11,6,5,54,0,3,1,2,33,2.9,444,34
kika,5.7,13,8,5,61,5.1,5,2,3,40,0,0,0
bhaji_on_the_beach,7.4,8,7,1,87,0,2,2,0,100,3.3,372,60
little_big_league,5.2,15,5,10,33,0,3,2,1,66,2.9,2288,50
kadisbellan-slingshot,6.9,9,8,1,88,0,1,1,0,100,3.5,76,59
wedding_gift,6,5,2,3,40,0,2,1,1,50,0,0,0
foreign_student,0,3,1,2,33,0,0,0,0,0,0,0,0
ciao_professore,6.2,7,4,3,57,0,2,1,1,50,3.6,412,71
spanking_the_monkey,7.2,21,19,2,90,0,2,2,0,100,3.1,824,52
little_rascals,3.8,10,2,8,20,0,0,0,0,0,0,0,0
andre,5.3,16,7,9,43,0,2,0,2,0,2.7,2286,52
la_scorta,5.9,7,4,3,57,0,3,0,3,0,3.3,52,59
princess_caraboo,5.7,14,8,6,57,0,3,0,3,0,3,723,43
celluloid_closet,7.8,24,23,1,95,8.6,5,5,0,100,3.9,1222,87
cafe_au_lait,5.9,6,4,2,66,0,2,1,1,50,0,0,0
caro_diario,6.7,9,6,3,66,0,2,0,2,0,4.1,936,86
brady_bunch_movie,5.7,38,23,15,60,6.4,11,7,4,63,2.4,3906,38
home_alone,5,30,14,16,46,0,2,0,2,0,3.3,66201,74
1031086-ghost,6.8,42,34,8,80,0,4,4,0,100,3.5,62365,79
terminator_2_judgment_day,8.4,42,41,1,97,7.4,11,10,1,90,3.7,77100,88
dances_with_wolves,7,46,35,11,76,6.9,10,7,3,70,3.6,28000,84
batman_the_movie,6.2,22,18,4,81,0,1,1,0,100,3,13951,51
silence_of_the_lambs,8.5,52,50,2,96,7.8,11,10,1,90,4,98921,93
the-house-of-magical-sounds,0,0,0,0,0,0,0,0,0,0,0,0,0
1038728-beauty_and_the_beast,8,57,52,5,91,7.8,18,17,1,94,3.7,81050,85
1016342-pinocchio,9,37,37,0,100,8.5,5,5,0,100,3.3,19102,66
pretty_woman,5.7,55,34,21,61,5.9,9,6,3,66,3.5,200724,68
window_to_paris,5.4,7,3,4,42,0,1,0,1,0,3.9,42,88
1059489-wild_bunch,8.8,38,37,1,97,8.2,7,6,1,85,4,8004,90
love_and_a_45,6.2,6,5,1,83,0,0,0,0,0,0,0,0
great_day_in_harlem,7.5,18,16,2,88,7.1,7,6,1,85,3.9,85,82
bye_bye_love,4.2,21,4,17,19,0,3,1,2,33,2.9,1015,49
1074374-one_fine_day,5.7,29,13,16,44,5.8,6,1,5,16,3.1,7990,63
candyman_farewell_to_the_flesh,4.9,10,4,6,40,0,1,0,1,0,2.7,4578,44
fargo,8.4,66,62,4,93,7.6,21,18,3,85,3.9,48610,91
homeward_bound_2_lost_in_san_francisco,5.7,16,9,7,56,6.4,7,5,2,71,2.9,5368,53
1068461-heavy_metal,5.7,25,15,10,60,5.4,5,3,2,60,3.3,6386,69
hellraiser-bloodline,3.5,10,3,7,30,0,1,0,1,0,2.9,4846,52
pallbearer,5,18,7,11,38,0,4,2,2,50,2.3,1285,14
loaded-2008,0,0,0,0,0,0,0,0,0,0,0,0,0
bread_and_chocolate,0,4,4,0,100,0,0,0,0,0,0,0,0
aristocats,6.1,26,17,9,65,0,4,3,1,75,3.3,23247,71
flower_of_my_secret,7,23,19,4,82,6.6,11,8,3,72,3.7,1997,75
two_much,3.6,7,1,6,14,0,3,0,3,0,2.7,947,33
cerro-torre-schrei-aus-stein-scream-of-stone,0,0,0,0,0,0,0,0,0,0,0,0,0
my_favorite_season_1993,7.3,12,11,1,91,0,3,3,0,100,0,0,0
modern_affair,0,2,0,2,0,0,1,0,1,0,3.2,63,38
halfaouine-boy-of-the-terraces,0,0,0,0,0,0,0,0,0,0,0,0,0
thin_line_between_love_and_hate,3.5,24,3,21,12,3.2,7,0,7,0,3.5,3360,73
last-supper,0,0,0,0,0,0,0,0,0,0,0,0,0
1070992-primal_fear,6.7,41,30,11,73,7.3,6,4,2,66,3.7,15640,85
rude-boy2003,0,0,0,0,0,0,0,0,0,0,0,0,0
1070604-carried_away,6,22,14,8,63,5.4,6,3,3,50,3.3,256,51
all_dogs_go_to_heaven_2,0,3,0,3,0,0,1,0,1,0,2.8,10564,48
land_and_freedom,7.8,10,8,2,80,0,2,2,0,100,4.3,1552,93
denise_calls_up,6.4,22,17,5,77,6.9,9,7,2,77,3.4,47,67
theodore_rex,0,4,0,4,0,0,0,0,0,0,0,0,0
family_thing,6.3,22,16,6,72,6.8,6,5,1,83,3.4,546,61
nina-frisk,0,0,0,0,0,0,0,0,0,0,0,0,0
sgt_bilko,4.4,36,12,24,33,5.4,10,6,4,60,2.6,3074,46
jack_and_sarah,6,11,9,2,81,0,2,1,1,50,3.6,1366,74
girl_6,4.6,32,11,21,34,4,11,1,10,9,0,0,0
1069985-diabolique,3.8,25,3,22,12,4,6,0,6,0,2.7,1450,35
little_indian_big_city,3.2,8,1,7,12,0,4,0,4,0,2.8,552,34
nelly_and_monsieur_arnaud,7.6,21,20,1,95,7.8,10,9,1,90,3.8,381,78
courage_under_fire,7.3,52,44,8,84,7.8,15,14,1,93,3.2,6918,61
mission_impossible_3,6.6,217,152,65,70,6.2,42,26,16,61,3.3,86328,69
cold_fever,7.3,10,9,1,90,0,3,3,0,100,3.9,284,81
1071414-moll_flanders,5.5,20,9,11,45,6.3,6,3,3,50,3.5,855,72
301-302,5.9,7,5,2,71,0,1,0,1,0,3.7,163,69
dragonheart,5.7,30,15,15,50,6.4,5,3,2,60,3.2,19438,63
my_mothers_courage,0,0,0,0,0,0,0,0,0,0,0,0,0
48_hrs,7.4,33,31,2,93,0,4,3,1,75,3.2,10471,61
billys_holiday,0,1,0,1,0,0,0,0,0,0,0,0,0
purple-noon,8.2,21,21,0,100,0,4,4,0,100,4,670,89
august_rush,4.8,120,44,76,36,4.4,27,7,20,25,4,105941,84
james_and_the_giant_peach,7,55,51,4,92,7.5,12,11,1,91,3,18876,55
1071258-fear,4.8,28,11,17,39,0,4,1,3,25,3.2,11285,66
kids_in_the_hall_brain_candy,4.7,33,13,20,39,4.3,9,3,6,33,3.4,2060,72
faithful,3.8,14,1,13,7,5,5,1,4,20,3.1,397,47
1088763-underground,7.5,18,15,3,83,0,4,4,0,100,4.4,6157,96
all_things_fair,0,1,1,0,100,0,0,0,0,0,0,0,0
bloodsport_ii_the_next_kumite,0,0,0,0,0,0,0,0,0,0,0,0,0
pather-panchali-song-of-the-little-road,8.9,33,32,1,96,8.6,6,6,0,100,4.5,1572,95
apur-sansar-the-world-of-apu1959,9,16,16,0,100,9.2,6,6,0,100,4.4,1009,94
mystery_science_theater_3000_the_movie,6.4,37,27,10,72,6.3,13,9,4,69,3.8,4508,86
space_jam,5.1,44,16,28,36,5.4,14,6,8,42,2.9,27911,52
barbarella,6,35,26,9,74,4.8,5,2,3,40,3,5461,55
some_folks_call_it_a_sling_blade,0,0,0,0,0,0,0,0,0,0,0,0,0
run_of_the_country,6,7,3,4,42,0,2,1,1,50,3.3,237,60
alphaville,7.9,25,21,4,84,0,2,1,1,50,3.9,4907,82
1004323-clean_slate,7.2,6,5,1,83,0,1,0,1,0,3.8,497,77
tigrero_a_film_that_was_never_made,0,2,2,0,100,0,0,0,0,0,0,0,0
eye_of_vichy,0,2,2,0,100,0,0,0,0,0,0,0,0
its_my_party,5.8,14,7,7,50,6.2,6,3,3,50,3.7,843,78
country_life,6.5,6,4,2,66,0,2,2,0,100,3.1,265,44
operation_dumbo_drop,4,24,7,17,29,0,3,2,1,66,2.4,2200,31
das-versprechen-the-promise,7,6,5,1,83,0,1,1,0,100,3.7,95,74
mrs_winterbourne,3.8,29,2,27,6,3.3,10,0,10,0,3.1,2892,60
1073182-solo,3.2,26,1,25,3,3.8,10,1,9,10,2.3,827,25
under_the_domim_tree,0,1,1,0,100,0,0,0,0,0,0,0,0
1069981-substitute,4.6,21,8,13,38,4.2,8,2,6,25,2.9,1815,44
1084928-true_crime,6,38,20,18,52,6.8,6,5,1,83,3.2,2873,51
butterfly_kiss,6.4,13,10,3,76,0,1,1,0,100,3.2,586,55
feeling_minnesota,3.8,19,3,16,15,0,4,1,3,25,2.7,2783,30
delta_of_venus,4.4,5,0,5,0,0,0,0,0,0,0,0,0
angus_thongs_and_perfect_snogging,6,24,17,7,70,0,2,1,1,50,3.9,6295,76
daens,0,0,0,0,0,0,0,0,0,0,0,0,0
faceoff,7.9,60,56,4,93,8.4,15,15,0,100,3.5,62348,81
boy-a,7.5,57,51,6,89,7.5,23,20,3,86,3.5,5895,84
galaxy_quest,7.2,111,99,12,89,6.9,27,22,5,81,3,19804,67
all-ladies-do-it,0,0,0,0,0,0,0,0,0,0,0,0,0
sunset_park,4.6,8,1,7,12,0,3,0,3,0,3.6,636,78
mulholland_falls,5.1,29,9,20,31,5.9,5,2,3,40,2.9,1519,40
truth_about_cats_and_dogs,6.7,36,30,6,83,7.6,6,5,1,83,2.9,6120,55
oliver_and_company,5.4,33,14,19,42,7.2,5,4,1,80,3.3,9618,65
celtic_pride,3.1,23,2,21,8,4.5,7,2,5,28,2.6,1756,30
1070621-flipper,4.8,17,5,12,29,5.4,5,1,4,20,2.6,6086,44
la-captive-the-captive,6.7,10,7,3,70,0,1,1,0,100,3,119,47
of_love_and_shadows,4.2,5,1,4,20,0,0,0,0,0,0,0,0
dead_man,6.8,33,23,10,69,5.8,6,2,4,33,4,16798,86
horseman_on_the_roof,6.6,20,13,7,65,6.4,5,3,2,60,3.7,1134,77
switchblade_sisters,5.4,19,10,9,52,4.4,7,2,5,28,3.5,847,69
mouth_to_mouth,5.8,9,3,6,33,0,2,1,1,50,3.3,162,56
1073317-visitors,5.4,11,4,7,36,0,3,0,3,0,3.7,3693,74
multiplicity,5.4,43,19,24,44,5.2,14,4,10,28,2.7,4648,43
the-haunted-world-of-edward-d-wood-jr,0,1,1,0,100,0,0,0,0,0,0,0,0
craft,5.4,29,13,16,44,5.5,6,2,4,33,3.1,23740,67
great_white_hype,5.1,20,9,11,45,6.6,5,3,2,60,2.7,1488,32
save_the_last_dance_for_me,0,0,0,0,0,0,0,0,0,0,0,0,0
1138201-war_stories,0,0,0,0,0,0,0,0,0,0,0,0,0
1071769-cold_comfort_farm,7.5,31,26,5,83,8.6,5,5,0,100,3.7,1564,79
the-institute-benjamenta,7.5,6,6,0,100,0,1,1,0,100,4.2,375,87
heavens_prisoners,4.1,19,3,16,15,4.9,5,1,4,20,2.7,457,25
1072011-rock,6.5,47,31,16,65,6,15,9,6,60,3.6,45013,85
getting_away_with_murder,3,7,0,7,0,0,3,0,3,0,2.8,747,29
cemetery_man,6,26,16,10,61,0,2,0,2,0,3.8,3149,78
1071167-twister,6,49,28,21,57,6.7,10,7,3,70,3.2,45771,62
le-garcu,0,0,0,0,0,0,0,0,0,0,0,0,0
ghost_in_the_shell,7.4,31,29,2,93,0,3,3,0,100,3.9,25483,87
thinner,3.8,17,3,14,17,0,3,0,3,0,2.7,3249,40
spy_hard,3.2,30,2,28,6,2.6,8,0,8,0,2.5,4450,37
brothers_in_trouble,0,3,3,0,100,0,0,0,0,0,0,0,0
wallace_and_gromit_a_close_shave,8.5,19,19,0,100,0,0,0,0,0,0,0,0
1007691-force_of_evil,8.6,12,12,0,100,0,2,2,0,100,3.7,600,74
stupids,3.1,14,3,11,21,0,2,1,1,50,2.3,2070,35
1071267-arrival,6.3,27,18,9,66,6.1,5,3,2,60,2.9,2211,41
dr_strangelove,9,58,58,0,100,8.6,8,8,0,100,4.2,33662,94
careful,6.4,11,9,2,81,0,4,3,1,75,4,200,79
month_by_the_lake,6.2,17,12,5,70,0,4,2,2,50,3.1,914,44
gold_diggers_the_secret_of_bear_mountain,6.2,8,4,4,50,0,4,1,3,25,0,0,0
1011597-kim,6.6,5,5,0,100,0,0,0,0,0,0,0,0
carmen_miranda_bananas_is_my_business,6,5,4,1,80,0,0,0,0,0,0,0,0
ashes_of_time_redux,6.6,69,54,15,78,6.7,18,14,4,77,3.6,2166,71
maya_lin_a_strong_clear_vision,7.5,6,6,0,100,0,2,2,0,100,3.8,180,72
1072969-stalingrad,7.1,7,5,2,71,0,1,1,0,100,4,2247,87
star-warpd,0,0,0,0,0,0,0,0,0,0,0,0,0
striptease,3.4,34,4,30,11,4.4,6,0,6,0,2.4,5832,28
summer_fling,0,1,1,0,100,0,0,0,0,0,0,0,0
this_is_spinal_tap,8.6,53,51,2,96,7.7,7,6,1,85,3.9,23608,91
1072875-jack,4,29,5,24,17,4.8,5,1,4,20,3,11920,57
i_shot_andy_warhol,6.7,25,19,6,76,8.3,6,5,1,83,3.4,1521,68
grass_harp,5.9,14,7,7,50,6.2,5,2,3,40,3.4,297,56
stalags,5.8,12,6,6,50,0,4,1,3,25,3.8,33,80
wend_kuuni,0,0,0,0,0,0,0,0,0,0,0,0,0
spirits_of_the_dead,6.6,18,16,2,88,0,1,1,0,100,3.5,736,65
trainspotting,8.2,55,49,6,89,7.7,14,12,2,85,4,88351,92
til_there_was_you,3.9,28,2,26,7,3.7,10,0,10,0,2.7,1660,36
1071806-independence_day,6.2,54,33,21,61,6.5,17,11,6,64,3.5,94416,75
stealing_beauty,5.9,47,25,22,53,5.9,11,6,5,54,3.5,5036,73
1072972-fan,4.8,25,10,15,40,5.3,5,2,3,40,2.8,5593,37
1010215-hunchback_of_notre_dame,8.3,9,9,0,100,0,0,0,0,0,0,0,0
cable_guy,5.4,54,28,26,51,4,14,2,12,14,2.8,27061,50
1072385-kingpin,5.8,35,18,17,51,5.7,5,3,2,60,3.1,13950,63
eraser,4.9,44,15,29,34,5.2,11,4,7,36,2.8,10891,43
gate_of_heavenly_peace,0,1,1,0,100,0,0,0,0,0,0,0,0
1071708-nutty_professor,6,51,34,17,66,6.7,15,13,2,86,2.9,25286,50
last_klezmer,0,2,2,0,100,0,0,0,0,0,0,0,0
hungarian_fairy_tale,0,1,1,0,100,0,0,0,0,0,0,0,0
artaud,6.9,6,5,1,83,0,2,1,1,50,0,0,0
very_natural_thing,0,1,0,1,0,0,0,0,0,0,0,0,0
daylight,4.7,27,6,21,22,4.9,6,0,6,0,2.8,7912,41
frighteners,6.3,25,18,7,72,5.1,6,2,4,33,3.3,9928,70
lone_star_state_of_mind,0,4,0,4,0,0,0,0,0,0,0,0,0
1072990-harriet_the_spy,5.1,29,13,16,44,4.8,13,4,9,30,2.6,3584,46
phenomenon,5.9,32,16,16,50,5.5,6,1,5,16,3,9166,62
walking_and_talking,7.1,21,18,3,85,0,4,3,1,75,3.6,674,67
shes_the_one,5.8,48,29,19,60,5.9,12,7,5,58,2.9,3031,39
1072381-time_to_kill,6.1,50,34,16,68,6.6,12,8,4,66,3.6,17074,83
american_buffalo,6.6,25,19,6,76,7.4,6,5,1,83,3,598,46
rendezvous_in_paris,6.8,17,13,4,76,6.5,6,4,2,66,3.6,158,63
mystery_alaska,4.9,78,29,49,37,5.1,26,11,15,42,3.2,4196,66
fled,4.3,29,4,25,13,4.5,11,2,9,18,2.6,1281,26
kazaam,2.5,25,1,24,4,3,10,0,10,0,1.8,3161,19
larger_than_life,4.1,17,2,15,11,4,6,0,6,0,2.6,1363,28
boy_called_hate,0,1,1,0,100,0,0,0,0,0,0,0,0
very_brady_sequel,5.6,32,16,16,50,6.5,9,6,3,66,2.3,4591,26
death_in_the_garden,7.8,11,10,1,90,0,2,2,0,100,3.4,201,47
crude_oasis,0,1,0,1,0,0,1,0,1,0,3.1,38,50
la-collectionneuse,7.1,9,8,1,88,0,2,1,1,50,3.9,566,83
mystery-of-kaspar-hauser-jeder-fur-sich-und-gott-gegen-alle,0,0,0,0,0,0,0,0,0,0,0,0,0
1070236-convent,3.5,7,2,5,28,0,0,0,0,0,0,0,0
1071706-adventures_of_pinocchio,4.8,15,4,11,26,5.4,5,1,4,20,2.6,1746,33
joes_apartment,3.8,26,4,22,15,3.6,8,1,7,12,2.5,3311,43
first_wives_club,5.4,32,13,19,40,5.7,7,2,5,28,3.2,9522,67
stonewall,6.5,8,5,3,62,0,3,1,2,33,3.4,282,57
1074298-ransom,6.4,30,21,9,70,5.7,7,4,3,57,3.1,10364,61
1194524-high_school_musical_3_senior_year,5.9,127,83,44,65,6,27,18,9,66,3.6,80210,76
phat_beach,0,3,0,3,0,0,1,0,1,0,3,375,46
1073285-foxfire,5.3,10,3,7,30,0,4,1,3,25,3.5,3071,67
1072457-chain_reaction,4.1,31,4,27,12,5.1,9,2,7,22,2.7,6845,33
1072107-matilda,7.4,20,18,2,90,7.4,5,5,0,100,3.1,24214,65
emma1996,0,0,0,0,0,0,0,0,0,0,0,0,0
crow_the_city_of_angels,3.4,33,4,29,12,3.3,8,1,7,12,3,12460,51
1073023-house_arrest,3.5,12,1,11,8,0,3,0,3,0,2.8,2789,44
eyes-without-a-face1960,8.2,42,41,1,97,7.8,9,8,1,88,4,785,86
tales_from_the_crypt_presents_bordello_of_blood,3.2,27,4,23,14,3.6,7,1,6,14,2.6,3764,41
story_of_xinghua,0,0,0,0,0,0,0,0,0,0,0,0,0
day_the_sun_turned_cold,0,3,2,1,66,0,0,0,0,0,0,0,0
flirt,6.6,10,7,3,70,0,2,0,2,0,3.7,271,71
big_squeeze,5,7,3,4,42,0,1,0,1,0,3.8,49,75
spitfire_grill,5.4,26,9,17,34,5.2,6,0,6,0,3.6,777,77
escape_from_la,5.6,45,25,20,55,5.9,14,8,6,57,2.8,10054,41
cyclo,6.5,11,8,3,72,0,0,0,0,0,0,0,0
night-graffiti,0,0,0,0,0,0,0,0,0,0,0,0,0
tin_cup,6.5,48,33,15,68,7,13,10,3,76,2.9,6148,57
cry_in_the_dark,6.8,20,18,2,90,0,1,1,0,100,3.3,1554,63
godfather,9,66,66,0,100,8.4,11,11,0,100,4.4,172072,97
maybe_maybe_not,5.9,9,5,4,55,0,3,2,1,66,3.5,359,64
supercop,7.3,37,35,2,94,6.8,9,8,1,88,3.4,4064,69
manny_and_lo,5.8,21,13,8,61,6.2,11,8,3,72,3.4,477,55
time_travelers_wife,5.1,151,56,95,37,4.8,34,10,24,29,2.9,189828,65
small_faces,6.7,9,6,3,66,0,2,2,0,100,4.1,183,85
bound,7.7,34,30,4,88,8.6,5,5,0,100,3.5,5521,80
carpool,2.4,10,0,10,0,0,3,0,3,0,2.6,1096,39
death_in_brunswick,0,4,2,2,50,0,0,0,0,0,0,0,0
kansas_city,5.9,33,19,14,57,6.2,9,5,4,55,3,608,37
gone_fishin,2.2,22,1,21,4,2.4,6,0,6,0,2.6,2183,39
vive-lamour,8.1,5,4,1,80,0,0,0,0,0,0,0,0
1077642-nothing_to_lose,5.1,23,6,17,26,5.7,5,1,4,20,3.1,5245,67
1072971-girls_town,6.8,23,20,3,86,7,10,9,1,90,3.8,173,76
relic,4.4,28,9,19,32,5.8,5,2,3,40,2.7,3098,36
1072156-island_of_dr_moreau,4.3,31,7,24,22,4,5,0,5,0,2.4,5032,26
first_kid,4,12,2,10,16,0,2,0,2,0,2.5,2541,37
trigger_effect,6.4,23,17,6,73,0,3,1,2,33,3,521,35
sweet-nothing-in-my-ear,0,0,0,0,0,0,0,0,0,0,0,0,0
bill_and_teds_bogus_journey,6,33,19,14,57,6,6,4,2,66,3,17201,59
bulletproof_monk,4.3,130,28,102,21,4,31,5,26,16,2.9,13789,50
talk_of_angels,0,3,2,1,66,0,0,0,0,0,0,0,0
land_before_time_iii_the_time_of_great_giving,0,4,2,2,50,0,0,0,0,0,0,0,0
miami_vice,5.6,189,89,100,47,6.4,41,28,13,68,2.8,55637,48
halloween_6_the_curse_of_michael_myers,2.5,27,1,26,3,1.7,6,0,6,0,3.1,12571,56
twelfth-night,6.8,30,21,9,70,6.5,10,7,3,70,3.7,1937,77
mother_night,6.3,23,14,9,60,6.4,5,2,3,40,3.6,706,74
wild_reeds,8.2,10,10,0,100,0,3,3,0,100,4,604,86
for_whom_the_bell_tolls,6.4,12,10,2,83,0,0,0,0,0,0,0,0
philadelphia_story,8.6,43,43,0,100,8,5,5,0,100,4.1,11465,92
singin_in_the_rain,9.2,44,44,0,100,8.8,9,9,0,100,3.9,28033,91
american_in_paris,7.9,47,46,1,97,7.2,5,5,0,100,3.7,6926,77
funny_face,7.6,22,19,3,86,0,2,2,0,100,3.7,8892,80
breakfast_at_tiffanys,7.4,43,37,6,86,7.4,5,5,0,100,3.9,56438,91
vertigo,8.6,54,53,1,98,8,14,13,1,92,4.1,28291,92
1017289-rear_window,8.9,60,60,0,100,8.7,17,17,0,100,4.2,33508,95
it_happened_one_night,8.7,32,31,1,96,8.2,5,5,0,100,4.1,7375,92
1008138-gaslight,7.6,16,14,2,87,0,1,1,0,100,4,2391,89
gay_divorcee,7.8,8,8,0,100,0,0,0,0,0,0,0,0
north-by-northwest,9,58,58,0,100,7.8,6,6,0,100,4.2,23243,93
1001115-apartment,8.3,43,39,4,90,7.6,8,7,1,87,4.1,9116,93
some_like_it_hot,8.9,40,39,1,97,0,4,4,0,100,4.1,23119,93
1003883-charade,8.1,33,30,3,90,6,5,3,2,60,4.1,9173,92
1003707-casablanca,9,58,56,2,96,7.7,7,6,1,85,4,66776,94
1013139-maltese_falcon,9,40,40,0,100,8.2,6,6,0,100,4,14452,90
my-fair-lady,8,36,34,2,94,8.6,6,6,0,100,3.7,27491,87
1018047-sabrina,7.4,31,28,3,90,7.2,5,5,0,100,3.8,12812,87
roman_holiday,8.2,43,42,1,97,7.5,6,5,1,83,4.1,17541,93
1061812-little_princess,8.4,20,19,1,95,0,3,3,0,100,3.4,13643,81
meet_me_in_st_louis,8.4,24,24,0,100,0,4,4,0,100,3.8,7067,84
1092277-wizard_of_oz,9.2,70,70,0,100,8.7,11,11,0,100,3.6,69148,82
gone_with_the_wind,8.7,62,60,2,96,8.3,13,13,0,100,3.9,62786,91
my_favorite_year,7.8,22,22,0,100,0,0,0,0,0,0,0,0
sunset_boulevard,9.2,52,51,1,98,8.2,7,7,0,100,4.3,12588,95
citizen_kane,9.4,54,54,0,100,8.9,7,7,0,100,4.1,33926,91
1000085-2001_a_space_odyssey,8.8,53,51,2,96,7.1,11,9,2,81,3.7,46687,86
golden_earrings,0,0,0,0,0,0,0,0,0,0,0,0,0
1000626-all_about_eve,9,54,54,0,100,8.2,10,10,0,100,4.2,10267,94
10009516-women,3.9,142,18,124,12,3.8,34,4,30,11,3,20081,41
1017293-rebecca,8.7,36,36,0,100,8.2,5,5,0,100,0,0,0
foreign_correspondent,7.9,28,26,2,92,0,3,3,0,100,3.7,1921,77
10009632-notorious,5.5,136,68,68,50,6.2,36,22,14,61,3.6,66668,66
1019609-spellbound,7.3,30,26,4,86,0,1,1,0,100,3.8,4332,82
affair_to_remember,6.4,25,16,9,64,0,1,0,1,0,4,7962,88
to_catch_a_thief,8,32,31,1,96,0,2,2,0,100,0,0,0
1037864-father_of_the_bride,5.8,29,21,8,72,0,2,2,0,100,3.2,22336,67
band_wagon,8.5,13,13,0,100,0,1,1,0,100,3.8,1257,79
ninotchka,8.3,23,23,0,100,0,3,3,0,100,4.1,1769,89
love_in_the_afternoon,7.1,23,20,3,86,0,4,4,0,100,3.8,2060,80
gigi,7.1,27,20,7,74,0,4,3,1,75,3.7,5450,75
reluctant_debutante,0,4,2,2,50,0,0,0,0,0,0,0,0
1000355-adventures_of_robin_hood,8.9,43,43,0,100,8.6,7,7,0,100,3.7,6404,84
mask_of_zorro,7.1,66,54,12,81,6.5,13,10,3,76,3.3,31107,70
1012007-laura,8.6,45,45,0,100,8,6,6,0,100,0,0,0
ghost_and_mrs_muir,8.2,12,12,0,100,0,0,0,0,0,0,0,0
lost_horizon,7.6,8,8,0,100,0,0,0,0,0,0,0,0
top_hat,8.6,37,37,0,100,8,6,6,0,100,4,2908,89
1021557-to_be_or_not_to_be,8.7,34,33,1,97,7,5,4,1,80,4.2,1733,92
1014536-my_man_godfrey,8.4,26,26,0,100,8,6,6,0,100,4.1,1789,90
giant,7.7,35,34,1,97,7.8,6,6,0,100,3.9,5890,86
1006416-east_of_eden,8.2,30,26,4,86,0,3,2,1,66,4,5957,90
thin_man,8.5,26,26,0,100,0,1,1,0,100,4.2,3591,93
his_girl_friday,8.6,36,35,1,97,0,4,4,0,100,0,0,0
around_the_world_in_80_days,4.8,127,39,88,30,4.7,33,9,24,27,2.7,14038,45
1010792-its_a_wonderful_life,8.7,54,51,3,94,8.4,6,6,0,100,4,35280,94
can-mr-smith-get-to-washington-anymore,7.4,12,10,2,83,7.4,7,6,1,85,3.6,869,66
bringing_up_baby,8.4,36,34,2,94,0,4,3,1,75,4,8722,90
penny_serenade,7.4,15,14,1,93,0,3,3,0,100,3.7,1083,74
1066120-scarlet_letter,3,33,5,28,15,3.6,11,1,10,9,2.9,3493,48
lady_of_burlesque,5.5,5,3,2,60,0,3,2,1,66,3.2,263,52
1015393-of_human_bondage,6.9,9,7,2,77,0,0,0,0,0,0,0,0
angel_on_my_shoulder,0,3,2,1,66,0,0,0,0,0,0,0,0
1012439-little_lord_fauntleroy,7,5,4,1,80,0,0,0,0,0,0,0,0
inspector_general,6.8,8,7,1,87,0,0,0,0,0,0,0,0
1000957-angel_and_the_badman,6.5,6,4,2,66,0,0,0,0,0,0,0,0
1000121-39_steps,8.8,32,31,1,96,0,4,4,0,100,3.8,5603,84
soldier-world-wide-entertainment,0,0,0,0,0,0,0,0,0,0,0,0,0
common_denominators,0,0,0,0,0,0,0,0,0,0,0,0,0
1015052-night_of_the_living_dead,8.5,45,43,2,95,7,5,4,1,80,3.7,26113,85
african_queen,8.7,29,29,0,100,0,3,3,0,100,3.8,6609,87
beat_the_devil,6.6,11,7,4,63,0,2,1,1,50,3.3,793,55
1003755-cat_on_a_hot_tin_roof,7.8,30,30,0,100,0,4,4,0,100,3.9,6600,91
last_time_i_saw_paris,6.3,6,5,1,83,0,2,1,1,50,3.1,883,44
meet_john_doe,7.2,13,11,2,84,0,0,0,0,0,0,0,0
battle_of_algiers,9,70,69,1,98,8.9,17,17,0,100,4.4,4132,95
farewell_to_arms,7.6,8,7,1,87,0,0,0,0,0,0,0,0
yes_madam,0,2,2,0,100,0,0,0,0,0,0,0,0
1015525-on_dangerous_ground,8.3,11,11,0,100,0,1,1,0,100,3.8,411,75
picnic,6.5,6,3,3,50,0,1,0,1,0,3.5,632,64
madagascar_skin,0,3,2,1,66,0,1,0,1,0,3.5,295,58
pompatus_of_love,3.8,6,1,5,16,0,2,1,1,50,2.9,52,31
fly_away_home,7.1,32,27,5,84,8.1,7,7,0,100,3,5636,63
1078165-bliss,5.8,12,6,6,50,0,4,1,3,25,3.4,337,58
grace_of_my_heart,6.7,22,16,6,72,0,4,0,4,0,3.6,611,71
brother_of_sleep,6.6,7,5,2,71,0,2,2,0,100,4.1,119,84
maximum_risk,4.3,31,9,22,29,4.2,10,3,7,30,2.8,2236,38
michael_collins,6.8,44,34,10,77,6.8,9,7,2,77,3.6,4673,79
rich_mans_wife,4.1,14,2,12,14,0,4,0,4,0,3,769,49
1072683-infinity,6.2,13,8,5,61,0,4,2,2,50,3.1,399,38
big_night,8,52,50,2,96,8.2,11,11,0,100,3.9,1944,84
1073075-last_man_standing,5.1,30,11,19,36,4,6,1,5,16,3.1,8711,56
1074539-caught,6.3,12,9,3,75,0,3,2,1,66,3.2,209,58
set_it_off,6,23,14,9,60,7.5,6,5,1,83,3.6,10301,86
2_days_in_the_valley,6.1,52,32,20,61,6,11,8,3,72,3,3984,48
curdled,4.3,12,2,10,16,0,2,0,2,0,3.4,441,62
1073315-associate,5.1,17,4,13,23,6.2,7,3,4,42,2.9,1259,52
eds_next_move,6.3,9,7,2,77,0,2,2,0,100,3.2,43,75
extreme_measures,6,31,17,14,54,5.7,6,2,4,33,2.9,2772,37
glimmer_man,3.4,24,3,21,12,2.6,9,0,9,0,2.7,2801,48
d3_the_mighty_ducks,3.7,14,2,12,14,0,4,0,4,0,2.8,9838,50
chamber,4.5,24,3,21,12,4.6,7,0,7,0,3,1633,43
apple_dumpling_gang,6,8,4,4,50,0,2,0,2,0,3.2,2133,60
davy_crockett_king_of_the_wild_frontier,0,4,4,0,100,0,0,0,0,0,0,0,0
escape_to_witch_mountain,6,20,15,5,75,0,3,2,1,66,3.1,3761,60
1012813-love_bug,5.7,15,11,4,73,0,4,1,3,25,3.1,3795,63
herbie_rides_again,0,4,3,1,75,0,0,0,0,0,0,0,0
old_yeller,7.7,17,16,1,94,0,2,2,0,100,3.3,6399,73
1083414-parent_trap,7,34,27,7,79,6.5,7,4,3,57,3.1,41455,67
1016512-pollyanna,7.4,11,9,2,81,0,2,2,0,100,3.3,3331,71
homeward_bound_the_incredible_journey,6.5,22,19,3,86,6.9,8,7,1,87,3.2,15019,66
shaggy_dog,4.4,103,28,75,27,4.8,29,10,19,34,2.9,41890,50
1020736-swiss_family_robinson,6.7,17,14,3,82,0,2,1,1,50,3.3,3986,71
1075251-that_darn_cat,3.8,14,1,13,7,0,4,0,4,0,2.5,2029,30
1000079-20000_leagues_under_the_sea,7.7,24,22,2,91,0,4,4,0,100,3.2,7628,57
1046227-cool_runnings,6,30,22,8,73,6,6,4,2,66,3.4,35317,77
1048301-angels_in_the_outfield,0,1,1,0,100,0,0,0,0,0,0,0,0
1004186-cinderella,7.3,26,24,2,92,8,5,5,0,100,3.5,63946,76
the-three-caballeros,6.8,15,13,2,86,0,4,3,1,75,3.3,2192,62
sword_in_the_stone,6,22,16,6,72,0,3,2,1,66,3.3,11900,68
so_dear_to_my_heart,0,0,0,0,0,0,0,0,0,0,0,0,0
robin_hood_prince_of_thieves,5.2,27,15,12,55,0,2,1,1,50,3.4,30722,72
mary_poppins,8.2,37,37,0,100,0,3,3,0,100,3.5,44140,79
dumbo,8.4,31,30,1,96,0,4,4,0,100,3.3,32327,65
petes_dragon,4.6,20,10,10,50,0,2,2,0,100,3.1,7622,59
bedknobs_and_broomsticks,6,28,17,11,60,4.8,5,1,4,20,3.3,15857,67
1029112-alice_in_wonderland,6.5,22,18,4,81,0,3,2,1,66,3.3,37778,70
fox_and_the_hound,6.6,22,15,7,68,0,3,3,0,100,3.4,24666,77
1072957-freeway,6.4,35,26,9,74,7.6,8,6,2,75,3.4,4677,73
sound_of_music,7.7,47,38,9,80,5,5,2,3,40,3.6,72590,86
die_hard,8.1,50,47,3,94,6.2,9,6,3,66,3.9,99625,91
lawnmower_man,4.9,19,9,10,47,0,0,0,0,0,0,0,0
unhook_the_stars,6.6,16,13,3,81,6.4,6,5,1,83,3.2,257,49
synthetic_pleasures,5.4,6,1,5,16,0,2,0,2,0,0,0,0
1018483-secret_agent,7.6,10,10,0,100,0,0,0,0,0,0,0,0
secrets_and_lies,8.6,34,32,2,94,9.2,7,7,0,100,4.1,3358,90
that_thing_you_do,7.1,50,46,4,92,7.2,17,16,1,94,3.2,14364,69
to_gillian_on_her_37th_birthday,4.7,27,4,23,14,5.2,7,0,7,0,2.9,1032,43
surviving_picasso,5,17,5,12,29,6.2,6,2,4,33,3.4,1054,58
love_is_all_there_is,0,2,0,2,0,0,0,0,0,0,0,0,0
beautiful_thing,6.8,20,18,2,90,6.8,8,7,1,87,4.3,3357,91
long_kiss_goodnight,6.1,29,20,9,68,4.1,6,0,6,0,3.3,10833,69
ghost_and_the_darkness,5.5,45,23,22,51,4.3,10,2,8,20,3.3,7987,71
looking_for_richard,7.1,45,37,8,82,6.5,12,8,4,66,3.6,1885,73
trees_lounge,6.9,25,20,5,80,0,4,3,1,75,3.6,1441,78
normal_life,6,10,7,3,70,0,2,2,0,100,3,289,45
get_on_the_bus,7.5,38,33,5,86,7.7,10,9,1,90,3.5,1014,70
shadow_conspiracy,3,27,0,27,0,3.3,9,0,9,0,2.6,692,24
jude,7.3,28,24,4,85,7.7,8,7,1,87,3.6,1931,71
everyone_says_i_love_you,7.3,41,32,9,78,7,9,5,4,55,3.4,6964,63
bitter_sugar,0,3,2,1,66,0,0,0,0,0,0,0,0
1102360-romeo_and_juliet,0,0,0,0,0,0,0,0,0,0,0,0,0
swingers,7.7,51,44,7,86,7.6,10,8,2,80,3.8,14060,89
1073595-sleepers,6.7,48,35,13,72,7.3,9,8,1,88,3.6,20694,81
1212848-sunchaser,3.9,5,1,4,20,0,1,0,1,0,3.3,191,52
indiana_jones_and_the_last_crusade,7.9,54,48,6,88,6.5,7,5,2,71,3.9,103952,91
aladdin-and-the-king-of-thieves,4.4,9,2,7,22,0,0,0,0,0,0,0,0
shall_we_dance,5.4,152,69,83,45,5.2,37,16,21,43,3,26935,63
damsel_in_distress,0,4,3,1,75,0,1,1,0,100,3.5,179,59
crossfire_1989,7.7,12,10,2,83,0,3,3,0,100,3.5,577,72
murder_my_sweet,7.7,14,13,1,92,0,0,0,0,0,0,0,0
macao,5.7,9,5,4,55,0,2,0,2,0,3.4,169,55
for-the-moment,0,0,0,0,0,0,0,0,0,0,0,0,0
willy_wonka_and_the_chocolate_factory,7.5,29,26,3,89,0,0,0,0,0,0,0,0
1099622-innocents,7.9,24,23,1,95,0,4,3,1,75,4,2095,85
sleeper,8,28,28,0,100,0,4,4,0,100,3.7,6718,80
bananas,7,18,16,2,88,0,1,1,0,100,3.6,4533,73
fish_called_wanda,8,46,44,2,95,7.8,8,7,1,87,3.4,15157,77
monty_pythons_life_of_brian,8.2,53,51,2,96,7.9,13,12,1,92,3.9,40453,91
victor-victoria,8,17,16,1,94,0,1,1,0,100,3.7,3624,82
1013227-manchurian_candidate,8.6,48,47,1,97,7.5,6,5,1,83,3.9,6006,89
1008852-great_race,6.1,20,15,5,75,0,2,2,0,100,3.8,2175,81
bonnie_and_clyde,8.1,46,41,5,89,6,7,4,3,57,3.7,12684,84
1070233-old_man_and_the_sea,6.4,8,7,1,87,0,0,0,0,0,0,0,0
dial_m_for_murder,7.2,26,21,5,80,6.8,6,5,1,83,3.9,9307,88
the-thistle-and-the-lotus,0,0,0,0,0,0,0,0,0,0,0,0,0
dirty_dancing,5.8,43,29,14,67,5.8,6,4,2,66,3.7,185439,88
reservoir_dogs,8.9,45,43,2,95,8.5,12,11,1,91,4.1,125757,93
platoon,7.8,42,36,6,85,6.8,10,7,3,70,3.9,49655,91
weekend_at_bernies,4.9,21,10,11,47,0,1,0,1,0,3,6596,57
basic_instinct,6,42,25,17,59,5.7,10,6,4,60,3.1,14326,64
doors,5.8,44,25,19,56,4.1,9,2,7,22,3.6,14440,80
crying_game,8.5,38,38,0,100,9.4,6,6,0,100,3.5,5761,76
glengarry_glen_ross,8.5,41,40,1,97,0,4,4,0,100,3.9,9083,87
sophies_choice,7.1,26,21,5,80,6.6,5,3,2,60,3.9,5468,87
et_the_extraterrestrial,8.9,89,87,2,97,8.6,18,17,1,94,3.5,154405,65
the-search-for-oneeye-jimmy,0,0,0,0,0,0,0,0,0,0,0,0,0
christmas_carol_1984miracle_on_34th_street_1994_2pack,0,0,0,0,0,0,0,0,0,0,0,0,0
days_of_thunder,4.6,43,17,26,39,5.6,8,5,3,62,3,14585,59
danger_zone_2,0,0,0,0,0,0,0,0,0,0,0,0,0
american_strays,0,0,0,0,0,0,0,0,0,0,0,0,0
rebel_without_a_cause,8.2,41,39,2,95,7.7,5,5,0,100,3.9,14558,87
1020333-streetcar_named_desire,8.5,46,45,1,97,8.5,5,5,0,100,3.9,13151,88
children_of_the_corn_iv_the_gathering,0,1,0,1,0,0,0,0,0,0,0,0,0
1098734-loser,4.2,94,23,71,24,4.5,26,9,17,34,2.6,5745,37
microcosmos,8,29,28,1,96,9.3,5,5,0,100,4,1418,89
palookaville,6.2,11,7,4,63,0,3,3,0,100,3.3,334,58
1073315-associate,5.1,17,4,13,23,6.2,7,3,4,42,2.9,1259,52
1074517-funeral,7,24,20,4,83,7.6,5,5,0,100,3.4,1110,65
sleepover,3.7,95,14,81,14,3.9,29,5,24,17,3.3,29842,62
a-single-girl,6.8,7,5,2,71,0,0,0,0,0,0,0,0
eighth_day,6.8,6,4,2,66,0,3,1,2,33,4,1377,86
punchdrunk_love,7.4,179,141,38,78,7.4,36,29,7,80,3.2,24379,72
people_vs_larry_flynt,7.7,53,46,7,86,7.7,15,13,2,86,3.3,7206,73
glory_daze,0,4,0,4,0,0,0,0,0,0,0,0,0
perfect_candidate,6.9,16,14,2,87,7.5,8,7,1,87,3.2,252,66
on_golden_pond,7.5,21,19,2,90,0,4,3,1,75,3.7,4024,84
return_of_the_pink_panther,6.6,16,14,2,87,0,0,0,0,0,0,0,0
drop_dead_fred,2.7,12,1,11,8,0,1,0,1,0,3.1,20039,72
abyss,7.2,43,38,5,88,6.5,6,4,2,66,3.5,17381,78
fog,2.7,66,3,63,4,2.8,11,0,11,0,2.5,14642,35
1006717-escape_from_new_york,6.8,45,37,8,82,0,4,2,2,50,3.4,15629,72
howling,6.1,25,15,10,60,0,1,0,1,0,3.2,4849,61
jean_de_florette,8,19,19,0,100,0,3,3,0,100,4.2,3691,94
manon_of_the_spring,8.9,13,13,0,100,0,2,2,0,100,4.2,2871,91
kinsey,7.6,187,168,19,89,7.9,39,36,3,92,3.4,6162,72
private_benjamin,6.7,22,19,3,86,0,1,1,0,100,3,3377,57
monty_python_and_the_holy_grail,7.8,51,48,3,94,7.1,13,12,1,92,4.1,94032,94
hustler_white,0,2,1,1,50,0,0,0,0,0,0,0,0
dadetown,0,4,3,1,75,0,3,2,1,66,0,0,0
everything_relative,4.9,8,2,6,25,0,4,1,3,25,3.2,49,50
entertaining_angels_the_dorothy_day_story,4.8,6,3,3,50,0,1,0,1,0,3.7,176,67
get_over_it,5.1,62,28,34,45,5.4,18,9,9,50,2.9,9761,51
three_lives_and_only_one_death,6.3,9,5,4,55,0,2,1,1,50,4,162,80
line_king_the_the_al_hirschfeld_story,0,2,2,0,100,0,0,0,0,0,0,0,0
when_we_were_kings,8.4,42,41,1,97,8.1,12,12,0,100,4.1,2489,91
wallace_and_gromit_the_wrong_trousers,9.1,24,24,0,100,0,0,0,0,0,0,0,0
the-return-of-martin-guerre,8,9,9,0,100,0,0,0,0,0,0,0,0
faust_love_of_the_damned,0,3,1,2,33,0,0,0,0,0,0,0,0
he_walked_by_night,7.6,6,5,1,83,0,0,0,0,0,0,0,0
1017226-raw_deal,3.8,12,3,9,25,0,1,0,1,0,2.7,3041,32
tmen,7.8,6,6,0,100,0,0,0,0,0,0,0,0
children_are_watching_us,0,2,2,0,100,0,0,0,0,0,0,0,0
la_symphonie_pastorale,0,0,0,0,0,0,0,0,0,0,0,0,0
tin_drum,7.3,12,9,3,75,0,1,0,1,0,4,2140,86
ruling_class,7.2,11,9,2,81,0,1,0,1,0,3.9,956,85
mina_tannenbaum,0,2,2,0,100,0,0,0,0,0,0,0,0
two_or_three_things_i_know_about_her,8,29,27,2,93,7.6,8,7,1,87,3.8,1050,73
dear_god,3.6,33,4,29,12,3.2,10,0,10,0,2.6,883,26
bad_moon,3.3,5,1,4,20,0,1,0,1,0,2.8,1122,41
best_of_the_best_3_no_turning_back,0,0,0,0,0,0,0,0,0,0,0,0,0
bob_roberts,7.5,34,34,0,100,7.4,7,7,0,100,3.5,1689,70
cinema_paradiso,7.9,56,50,6,89,7.8,15,13,2,86,4.4,21396,96
cook_the_thief_his_wife_and_her_lover,7.3,37,33,4,89,8,7,6,1,85,3.9,5208,88
dead_tired,6.8,6,3,3,50,0,2,1,1,50,3.3,124,60
delicatessen,7.6,39,34,5,87,5.4,6,3,3,50,4.1,14805,91
double_life_of_veronique,7.6,25,21,4,84,7.6,5,5,0,100,4.3,5676,92
enchanted_april,7.2,19,17,2,89,0,2,2,0,100,3.9,2525,80
paths_of_glory,8.6,39,36,3,92,7.1,7,5,2,71,0,0,0
grifters,7.9,38,34,4,89,7.1,8,6,2,75,3.4,2730,69
hear_my_song,7.1,12,11,1,91,0,2,2,0,100,3.7,154,74
english_patient,7.7,58,48,10,82,7.8,17,15,2,88,3.6,22977,82
mediterraneo,6.3,13,10,3,76,0,1,0,1,0,4.1,1443,91
my_left_foot,8.2,30,30,0,100,8.1,5,5,0,100,3.9,5875,90
sex_lies_and_videotape,7.9,34,33,1,97,8,5,5,0,100,3.3,5946,73
passion_fish,7.8,22,22,0,100,0,3,3,0,100,3.6,614,79
dancing-ballroom,0,0,0,0,0,0,0,0,0,0,0,0,0
thin_blue_line,8.7,11,11,0,100,0,1,1,0,100,4,1805,89
tie_me_up_tie_me_down,6.5,23,17,6,73,0,4,1,3,25,3.7,4683,79
madonna_truth_or_dare,6.1,16,12,4,75,0,2,2,0,100,3.2,2102,62
paris_is_burning,7.4,9,9,0,100,0,2,2,0,100,4,878,82
one_flew_over_the_cuckoos_nest,8.8,50,48,2,96,6.3,6,4,2,66,4.2,61369,95
up-in-smoke,5.1,16,7,9,43,0,2,0,2,0,3.6,11888,81
empire_strikes_back,8.6,71,69,2,97,7.5,17,15,2,88,4.1,146071,94
princess_bride,8.2,44,42,2,95,7.4,7,6,1,85,4,116640,92
veggietales-silly-little-thing-called-love,0,0,0,0,0,0,0,0,0,0,0,0,0
1003033-brazil,8.6,40,39,1,97,7.2,8,7,1,87,4.1,35162,89
1000617-aliens,8.8,47,47,0,100,8,7,7,0,100,3.8,72406,90
good_the_bad_and_the_ugly,8.7,62,61,1,98,8,11,10,1,90,4,40790,93
withnail_and_i,8.3,28,26,2,92,0,1,1,0,100,4.4,11574,95
1000013-12_angry_men,8.8,36,36,0,100,0,4,4,0,100,4.1,22784,95
lawrence_of_arabia,8.8,56,55,1,98,8.3,15,14,1,93,4.1,22451,91
great-writers-anthony-burgess,0,0,0,0,0,0,0,0,0,0,0,0,0
to_kill_a_mockingbird,8.8,39,38,1,97,0,3,3,0,100,3.8,19861,91
apocalypse_now,8.8,61,60,1,98,8.4,11,10,1,90,4.1,67647,93
once_upon_a_time_in_the_west,9,48,47,1,97,7.2,5,4,1,80,4.3,18310,94
return_of_the_jedi,6.7,63,49,14,77,6.4,17,13,4,76,4,137818,93
wings_of_desire,8.5,39,38,1,97,7.5,6,5,1,83,4.4,9110,94
the-third-man,9.1,57,57,0,100,8.2,14,14,0,100,4.3,13251,94
1032176-goodfellas,8.8,58,56,2,96,7.8,10,9,1,90,4.3,124589,96
american-alien,0,0,0,0,0,0,0,0,0,0,0,0,0
army_of_darkness,6.9,37,27,10,72,0,4,2,2,50,3.8,33240,85
1002303-big_blue,5.8,12,8,4,66,0,2,0,2,0,4.1,10653,92
ran,8.7,56,54,2,96,8.5,11,11,0,100,4.3,9990,94
1032434-killer,8.6,31,31,0,100,0,4,4,0,100,4,6079,91
psycho,8.9,67,66,1,98,7.5,8,7,1,87,3.9,32475,90
blues_brothers,6.9,45,38,7,84,4.8,5,2,3,40,3.7,29786,89
godfather_part_ii,9.2,55,54,1,98,7.3,6,5,1,83,4.3,106035,96
full_metal_jacket,8.2,55,53,2,96,7.7,8,7,1,87,4,77926,93
wallace_and_gromit_a_grand_day_out,8.3,19,19,0,100,0,0,0,0,0,0,0,0
1029042-henry_v,8.2,32,32,0,100,7.8,7,7,0,100,4,3619,87
amadeus,8.6,69,66,3,95,8.1,12,11,1,91,3.9,24420,94
quiet_man,8,34,31,3,91,0,4,4,0,100,4.1,6203,91
once_upon_a_time_in_america,8.4,29,27,2,93,0,4,3,1,75,4.2,25390,92
raging_bull,9,54,53,1,98,8.1,9,8,1,88,4.1,33528,92
annie_hall,8.8,46,45,1,97,8.2,5,5,0,100,3.9,27350,92
right_stuff,8.6,30,29,1,96,0,1,1,0,100,3.9,5615,87
1043378-stalker,8.2,16,16,0,100,0,2,2,0,100,4.5,6877,95
das_boot,9,36,36,0,100,8.5,5,5,0,100,4.1,11718,94
1020130-sting,8.1,45,41,4,91,6.9,5,4,1,80,4.1,16187,93
harold_and_maude,7.6,38,32,6,84,0,4,0,4,0,4.2,15115,93
trust_the_man,4.6,100,27,73,27,4.5,25,3,22,12,2.9,11451,38
seventh_seal,9,46,43,3,93,0,4,3,1,75,4.3,12987,94
local_hero,8.8,30,30,0,100,0,4,4,0,100,4.1,2127,87
terminator_4,5,251,80,171,31,4.9,35,10,25,28,3.4,267474,64
dead_alive,7.4,20,17,3,85,0,1,1,0,100,3.8,16839,84
1008415-glory,7.9,40,37,3,92,7.4,9,8,1,88,4,13978,92
rosencrantz_and_guildenstern_are_dead,6.3,27,18,9,66,0,4,0,4,0,4,4144,89
manhattan,8.6,43,42,1,97,8.5,6,6,0,100,4.1,14496,92
millers_crossing,8,51,46,5,90,6.9,9,7,2,77,4,14665,90
dead_poets_society,7.2,49,42,7,85,6.5,7,5,2,71,3.8,56733,90
graduate,8,44,39,5,88,6.7,6,5,1,83,3.7,22493,90
touched-by-evil,0,0,0,0,0,0,0,0,0,0,0,0,0
bridge_on_the_river_kwai,8.8,43,41,2,95,7.9,6,5,1,83,3.9,10774,90
8-12,8.4,34,33,1,97,7.5,9,8,1,88,4.3,12375,92
chinatown,9.3,47,47,0,100,8.8,6,6,0,100,4.2,22995,92
1005371-day_the_earth_stood_still,8,50,47,3,94,7,5,4,1,80,3.8,8999,86
treasure_of_the_sierra_madre,9,38,38,0,100,8.5,5,5,0,100,4.1,6732,90
bad_taste,6.4,20,14,6,70,0,0,0,0,0,0,0,0
duck_soup,8.9,35,33,2,94,0,4,3,1,75,4.1,7416,91
1002213-better_off_dead,7,21,17,4,80,0,1,1,0,100,3.7,11561,86
shining,7.8,45,39,6,86,5.4,6,3,3,50,4,91362,91
1019794-stand_by_me,7.8,34,32,2,94,0,2,2,0,100,0,0,0
1012928-m,9,40,40,0,100,8.4,8,8,0,100,4.3,9191,94
evil-dead-2,7.8,42,41,1,97,6.6,6,5,1,83,3.8,30657,86
secrets-of-the-great-wall2004,0,0,0,0,0,0,0,0,0,0,0,0,0
deer_hunter,8.3,44,40,4,90,7.1,5,4,1,80,4.1,27513,91
1005973-diva,8.1,41,39,2,95,8,14,13,1,92,4,1807,86
groundhog_day,7.9,52,50,2,96,7.5,10,10,0,100,3.3,34921,79
1041911-unforgiven,8.5,56,54,2,96,7.5,11,9,2,81,4,27203,91
1013227-manchurian_candidate,8.6,48,47,1,97,7.5,6,5,1,83,3.9,6006,89
pump_up_the_volume,6.7,31,25,6,80,0,3,2,1,66,3.4,5356,79
arsenic_and_old_lace,7.6,21,19,2,90,0,3,2,1,66,4,9161,91
back_to_the_future,8.4,54,52,2,96,7.3,6,5,1,83,3.8,126816,88
fried_green_tomatoes,6.5,22,18,4,81,0,3,3,0,100,3.7,24457,88
patton,8.2,36,35,1,97,8.3,6,5,1,83,4,8522,93
down_by_law,7.4,24,21,3,87,6.1,6,4,2,66,4.3,6805,94
akira,7.3,34,30,4,88,6.9,6,5,1,83,4,33398,89
highlander,5.9,29,19,10,65,0,2,1,1,50,3.5,18748,78
cool_hand_luke,8.8,44,44,0,100,8.5,6,6,0,100,4.1,17521,93
1005099-cyrano_de_bergerac,6.9,12,10,2,83,0,3,1,2,33,3.8,668,81
young_frankenstein,8.5,46,43,3,93,0,4,4,0,100,3.8,37773,91
night_on_earth,6.3,16,13,3,81,0,2,2,0,100,4,5592,91
raise_the_red_lantern,8.4,24,23,1,95,7.6,9,8,1,88,4.1,5193,92
great_dictator,8.9,34,32,2,94,8.8,7,6,1,85,4.2,16082,93
fantasia,8.5,42,41,1,97,8.3,6,6,0,100,3.5,12184,77
1046060-high_noon,8.8,41,39,2,95,8.5,5,5,0,100,3.9,6074,87
1002352-big_sleep,8.6,43,41,2,95,7.5,8,7,1,87,4.1,7772,91
heathers,7.8,41,39,2,95,7,9,7,2,77,3.7,17025,82
somewhere_in_time,5.8,16,10,6,62,0,4,1,3,25,3.9,7602,88
benhur,7.8,33,30,3,90,0,4,3,1,75,3.7,25817,80
this_is_spinal_tap,8.6,53,51,2,96,7.7,7,6,1,85,3.9,23608,91
koyaanisqatsi_life_out_of_balance,8,18,16,2,88,0,1,1,0,100,4.3,4109,91
some_kind_of_wonderful,6.4,33,26,7,78,5.8,6,4,2,66,3.5,7505,78
indiana_jones_and_the_last_crusade,7.9,54,48,6,88,6.5,7,5,2,71,3.9,103952,91
being_there,8.4,38,36,2,94,0,4,4,0,100,4.1,6371,91
gandhi,7.7,40,34,6,85,6.9,5,4,1,80,3.9,10562,91
unbearable_lightness_of_being,8.3,17,16,1,94,0,2,1,1,50,3.9,5178,84
1017864-room_with_a_view,8.6,21,21,0,100,0,2,2,0,100,3.9,6394,85
real_genius,6.5,23,17,6,73,0,4,2,2,50,3.5,6720,78
pink_floyd_the_wall,6.5,17,11,6,64,0,0,0,0,0,0,0,0
killing_fields,8.1,33,30,3,90,5.8,6,3,3,50,4,6389,89
my-life-as-a-dog,7.9,28,28,0,100,0,3,3,0,100,4.1,2751,88
forbidden_planet,8.1,36,35,1,97,0,2,2,0,100,3.8,4780,82
field_of_dreams,7.7,45,41,4,91,5.9,8,5,3,62,3.4,16498,85
man_who_would_be_king,8.6,20,19,1,95,0,4,3,1,75,4,3790,88
1003318-butch_cassidy_and_the_sundance_kid,8.1,42,38,4,90,6.5,5,3,2,60,3.9,17396,90
paris_texas,8.2,25,25,0,100,0,1,1,0,100,4.2,6389,93
until_the_end_of_the_world,6.5,12,10,2,83,0,1,0,1,0,4.1,1508,87
when_harry_met_sally,7.8,47,43,4,91,6.2,8,6,2,75,3.5,47834,83
hype,7.5,6,6,0,100,0,2,2,0,100,3.9,430,85
santa_with_muscles,0,3,0,3,0,0,0,0,0,0,0,0,0
female_perversions,6.3,21,14,7,66,6.8,9,7,2,77,3.1,264,48
mad_dog_time,2.9,6,1,5,16,0,2,0,2,0,2.9,429,48
breathing-room,0,0,0,0,0,0,0,0,0,0,0,0,0
im_not_rappaport,5.6,15,5,10,33,0,4,1,3,25,3.4,285,61
blue_juice,0,2,0,2,0,0,1,0,1,0,3,1487,46
alien_3,5,39,15,24,38,5.8,7,4,3,57,3.1,30526,55
american_werewolf_in_london,7.5,43,38,5,88,0,4,2,2,50,3.4,18421,76
amityville-its-about-time,2.3,7,1,6,14,0,0,0,0,0,0,0,0
amityville_3d,2.9,15,0,15,0,0,2,0,2,0,2.7,2070,32
amityville_dollhouse,0,2,0,2,0,0,0,0,0,0,0,0,0
amityville_a_new_generation,0,1,0,1,0,0,0,0,0,0,0,0,0
amityville_2_the_possession,2.7,14,1,13,7,0,1,0,1,0,2.9,3306,47
amityville_horror,4.2,155,37,118,23,3.9,33,7,26,21,3.2,31070,64
amityville_curse,3.6,5,1,4,20,0,0,0,0,0,0,0,0
blood-for-dracula,6.4,15,10,5,66,0,2,1,1,50,3.4,1432,58
1194078-april_fools_day,0,3,0,3,0,0,0,0,0,0,0,0,0
audrey_rose,5.4,9,5,4,55,0,0,0,0,0,0,0,0
1183429-believers,0,3,0,3,0,0,0,0,0,0,0,0,0
1002448-birds,8,40,38,2,95,0,4,2,2,50,3.5,17449,80
1002585-blob,5.6,16,9,7,56,0,0,0,0,0,0,0,0
blood_beach,2.6,6,0,6,0,0,0,0,0,0,0,0,0
1040324-body_parts,4.4,15,6,9,40,0,1,0,1,0,2.6,958,31
1010678-invasion_of_the_body_snatchers,8.9,36,36,0,100,0,2,2,0,100,3.6,3820,81
1006234-dracula,7.7,42,39,3,92,7.7,6,6,0,100,3.6,8598,76
bride_of_frankenstein,8.9,39,39,0,100,8.6,6,6,0,100,3.7,4867,82
burnt_offerings,5.2,8,3,5,37,0,1,0,1,0,3.1,927,45
candyman,6.3,37,27,10,72,5.4,5,3,2,60,3,12889,58
1037581-cape_fear,6.9,38,29,9,76,8.3,6,6,0,100,3.4,13943,74
1037581-cape_fear,6.9,38,29,9,76,8.3,6,6,0,100,3.4,13943,74
1003625-carrie,8,42,38,4,90,6.4,7,4,3,57,3.3,23161,70
1003758-cat_people,6.1,36,23,13,63,0,3,2,1,66,3,2400,46
nightmare_on_elm_street,7.7,40,38,2,95,0,4,4,0,100,3.5,57452,78
nosferatu,8.9,47,46,1,97,8.2,5,5,0,100,3.9,11264,86
nosferatu-a-venezia-nosferatu-in-venice-vampire-in-venice,0,0,0,0,0,0,0,0,0,0,0,0,0
1015517-omen,7,32,27,5,84,0,2,1,1,50,3.5,17016,78
blood_and_wine,6.1,31,19,12,61,6.5,9,6,3,66,3,951,36
albino_alligator,5.5,17,8,9,47,5.4,6,2,4,33,3,1198,42
mirror_has_two_faces,5.3,28,15,13,53,0,4,1,3,25,3.5,2549,72
breaking_the_waves,8,42,36,6,85,7.8,7,6,1,85,4.1,7949,91
1148279-night_watch,5.9,125,73,52,58,5.9,30,17,13,56,3.3,19774,70
star_trek_first_contact,7.4,52,48,4,92,7.4,13,12,1,92,3.5,20013,84
shine,8,31,28,3,90,8.8,7,7,0,100,3.8,6087,89
sling_blade,8.3,49,47,2,95,7.9,16,14,2,87,3.9,10557,91
jingle_all_the_way,4,38,6,32,15,5.3,6,1,5,16,2.6,10937,42
paradise_lost_the_child_murders_at_robin_hood_hills,8.2,24,23,1,95,0,3,3,0,100,4.1,1701,90
preachers_wife,5.8,38,23,15,60,7.2,11,8,3,72,2.9,3793,54
zero-kelvin,0,0,0,0,0,0,0,0,0,0,0,0,0
ridicule,7.3,17,13,4,76,8.2,5,5,0,100,3.8,979,83
1074978-crucible,7.2,26,20,6,76,8.3,6,4,2,66,3.2,4752,64
1036674-101_dalmatians,8,37,36,1,97,7.6,5,5,0,100,3.3,29711,63
i-cant-sleep,7.5,7,5,2,71,0,2,1,1,50,3.4,283,70
die_hard,8.1,50,47,3,94,6.2,9,6,3,66,3.9,99625,91
star_trek_the_motion_picture,5.8,31,15,16,48,4.8,5,2,3,40,3.1,14598,48
star_trek_vi_the_undiscovered_country,6.8,46,38,8,82,7.1,6,5,1,83,3.5,13463,77
star_trek_v_the_final_frontier,4,41,9,32,21,3.4,7,0,7,0,2.8,11133,37
star_trek_ii_the_wrath_of_khan,7.8,40,36,4,90,7.1,6,5,1,83,3.7,18490,86
star_trek_iii_the_search_for_spock,6.4,38,29,9,76,6.4,6,5,1,83,3.3,13649,60
star_trek_iv_the_voyage_home,6.8,37,31,6,83,6.2,7,5,2,71,3.5,14361,77
batman_returns,6.5,46,36,10,78,5.8,9,6,3,66,3.3,65412,68
young_guns,4.6,25,10,15,40,0,3,1,2,33,3.5,11858,77
young_guns_2,4.9,16,6,10,37,0,2,0,2,0,3.2,7476,67
grease,6.7,54,45,9,83,5.9,11,9,2,81,3.7,176349,85
grease,6.7,54,45,9,83,5.9,11,9,2,81,3.7,176349,85
marked_for_death,3.2,9,2,7,22,0,0,0,0,0,0,0,0
adrenalin_fear_the_rush,1.4,5,0,5,0,0,1,0,1,0,2.7,684,30
substance_of_fire,6.1,10,6,4,60,0,3,1,2,33,3,189,26
under_siege,6.2,23,17,6,73,0,3,2,1,66,3,9661,60
terror_in_a_texas_town,0,3,3,0,100,0,0,0,0,0,0,0,0
jaws,8.8,37,37,0,100,8.5,5,5,0,100,3.5,63534,81
jaws,8.8,37,37,0,100,8.5,5,5,0,100,3.5,63534,81
jaws_3,2.9,24,3,21,12,0,2,0,2,0,2.5,15576,33
my_fellow_americans,5.2,38,19,19,50,4.6,14,4,10,28,3.2,1831,61
mars_attacks,5.8,56,28,28,50,5.4,15,6,9,40,2.8,24991,49
citizen_ruth,6.8,24,19,5,79,6,5,3,2,60,3.5,998,72
jerry_maguire,7.4,57,48,9,84,7.5,19,17,2,89,3.3,32601,72
raising_arizona,7.6,49,44,5,89,5.5,6,3,3,50,3.6,19379,82
tin_men,6.4,19,15,4,78,0,1,1,0,100,3.1,778,54
sneakers,6.8,45,36,9,80,6.4,7,5,2,71,3.4,6830,77
bastard_out_of_carolina,7.1,9,9,0,100,0,0,0,0,0,0,0,0
1074467-in_love_and_war,4.1,26,3,23,11,3.4,6,0,6,0,3,2942,52
marvins_room,6.7,47,38,9,80,6,13,9,4,69,3.2,4558,58
ghosts_of_mississippi,5.8,26,13,13,50,6.4,7,3,4,42,3.4,1916,64
night_falls_on_manhattan,6.7,26,17,9,65,8,5,4,1,80,3.2,471,49
beavis_and_butthead_do_america,6.2,51,36,15,70,6.4,12,8,4,66,3,19512,61
1075705-ceremonie,7.7,27,25,2,92,7.4,12,11,1,91,3.9,747,85
1074316-scream,7,53,43,10,81,6.6,14,10,4,71,3.2,50339,70
1040678-last_of_the_mohicans,8,32,31,1,96,7.9,7,7,0,100,3.6,34073,84
michael_clayton,7.6,192,173,19,90,7.9,37,35,2,94,3.6,123924,72
evening_star,4.2,25,6,19,24,4.2,6,1,5,16,3.2,1029,59
1075422-hamlet,8.2,54,51,3,94,7.2,14,11,3,78,3.8,5816,86
some_mothers_son,6.3,15,10,5,66,6.8,6,3,3,50,4,520,86
whole_wide_world,6.9,15,12,3,80,0,4,3,1,75,3.6,707,73
1132642-mother,7,88,68,20,77,7.4,32,29,3,90,3.4,862,61
1076146-thieves,7,11,9,2,81,0,4,4,0,100,3.4,257,64
evita,6.5,31,19,12,61,6.4,6,4,2,66,3.1,8855,65
1074321-portrait_of_a_lady,5.5,28,12,16,42,6.2,6,3,3,50,3.2,2438,50
walkabout,8.1,26,24,2,92,0,3,3,0,100,3.9,1862,86
message-to-love,0,0,0,0,0,0,0,0,0,0,0,0,0
the-grateful-dead,0,0,0,0,0,0,0,0,0,0,0,0,0
murder_at_1600,5,30,10,20,33,5.3,6,1,5,16,2.9,4012,48
hearts-and-minds,0,0,0,0,0,0,0,0,0,0,0,0,0
fierce_creatures,5.6,31,17,14,54,5.6,5,1,4,20,3.1,3023,56
zeus_and_roxanne,4.4,7,3,4,42,0,1,0,1,0,2.9,1549,47
1074496-turbulence,3.2,18,3,15,16,0,4,0,4,0,2.5,718,23
jackie_chans_first_strike,6,21,11,10,52,0,4,2,2,50,3,4216,55
underworld,4.7,155,47,108,30,4.4,32,5,27,15,3.6,101467,82
beverly_hills_ninja,3.2,28,4,24,14,4.6,8,3,5,37,2.8,13679,54
1074675-1074675-metro,4,33,5,28,15,3.6,9,1,8,11,2.6,2757,31
1112951-time_machine,4.8,146,41,105,28,5,32,6,26,18,2.7,10389,45
the_strangers,5,146,65,81,44,4.8,26,13,13,50,3.1,55773,48
evolutionary-masturbation,0,0,0,0,0,0,0,0,0,0,0,0,0
dantes_peak,4.9,25,7,18,28,4.8,7,0,7,0,2.7,20021,45
meet_wally_sparks,2.5,14,2,12,14,0,2,1,1,50,2.6,586,32
amos_and_andrew,4,23,5,18,21,3.9,8,1,7,12,2.7,1624,36
benny_and_joon,5.7,30,22,8,73,5.1,8,4,4,50,3.6,28905,85
prefontaine,6.4,26,16,10,61,6.7,9,5,4,55,3.7,1530,79
guantanamera,6.9,9,7,2,77,0,3,2,1,66,3.5,310,69
1076097-mchales_navy,2.2,29,1,28,3,1.7,7,0,7,0,2.6,1386,36
kolya,7.8,22,21,1,95,8.8,6,6,0,100,4.2,2011,91
gridlockd,6.8,31,27,4,87,7.1,10,9,1,90,3.6,2054,79
waiting_for_guffman,7.7,53,48,5,90,7.2,11,9,2,81,3.9,8495,90
prisoner-of-the-mountains,7.2,23,20,3,86,8.3,8,8,0,100,3.9,356,85
beautician_and_the_beast,4.6,18,3,15,16,4.7,6,1,5,16,2.4,2687,43
1075781-suburbia,6.3,21,13,8,61,6.4,6,3,3,50,3.3,1247,66
hotel_de_love,5.1,8,2,6,25,0,3,0,3,0,3.7,121,67
pest,2.3,23,2,21,8,2.2,7,1,6,14,2.7,4963,63
fools_rush_in,4.8,27,9,18,33,5.1,7,2,5,28,3,9687,61
1074505-touch,4.7,17,5,12,29,0,3,0,3,0,2.9,494,36
absolute_power,5.5,41,19,22,46,6.2,10,5,5,50,3.2,6094,52
1075251-that_darn_cat,3.8,14,1,13,7,0,4,0,4,0,2.5,2029,30
vegas_vacation,3.8,28,4,24,14,3.2,10,1,9,10,3,7915,55
that_old_feeling,5,15,6,9,40,0,4,2,2,50,3,901,57
lost_highway,6.2,39,23,16,58,6,6,2,4,33,3.9,17451,87
rosewood,7.1,47,40,7,85,7,11,8,3,72,3.7,1445,82
donnie_brasco,7.8,54,47,7,87,7.1,16,12,4,75,3.7,40329,85
booty_call,4.2,12,3,9,25,5.4,6,2,4,33,2.8,3264,56
boys_life_2,6.7,5,4,1,80,0,2,2,0,100,3.3,79,64
city_of_industry,5.2,13,6,7,46,4.7,6,1,5,16,2.9,791,31
children_of_men,8,208,193,15,92,7.8,41,37,4,90,3.7,127695,81
jungle_2_jungle,4,39,7,32,17,4.2,13,3,10,23,2.7,9218,44
kama_sutra_a_tale_of_love,5,18,7,11,38,5.9,5,2,3,40,3.5,1793,72
private-parts,0,0,0,0,0,0,0,0,0,0,0,0,0
love_jones,6.4,15,10,5,66,6.8,5,4,1,80,4.2,4854,96
saint,4.6,44,13,31,29,4.3,15,3,12,20,3.1,11647,62
smillas_sense_of_snow,6,32,17,15,53,6.5,7,4,3,57,3.3,1224,59
unhuman,0,0,0,0,0,0,0,0,0,0,0,0,0
1144992-crash,7.1,197,148,49,75,7.1,39,30,9,76,4,98746,89
daytrippers,6.4,22,16,6,72,0,4,3,1,75,3.5,621,67
liar_liar,6.9,51,42,9,82,7.5,15,13,2,86,3.4,93496,72
quiet_room,0,4,3,1,75,0,0,0,0,0,0,0,0
1073427-selena,6,38,24,14,63,6.2,9,6,3,66,3.2,17729,76
devils_own,5.3,34,10,24,29,6.3,7,2,5,28,3,7624,46
cats_dont_dance,6.5,15,10,5,66,0,4,3,1,75,3.5,2510,72
baps,3,30,4,26,13,4.9,8,3,5,37,2.9,1372,57
love_and_other_catastrophes,5.5,13,6,7,46,0,3,0,3,0,3.8,270,75
turbo_a_power_rangers_movie,3.8,17,3,14,17,3.8,8,2,6,25,2.7,1946,42
1001063-anna_karenina,7.4,7,7,0,100,0,0,0,0,0,0,0,0
double_team,3.8,19,2,17,10,4.8,5,0,5,0,2.2,4157,31
inventing_the_abbotts,5.4,25,8,17,32,5.4,7,2,5,28,3.2,2432,54
anaconda,4.7,45,17,28,37,5.6,10,5,5,50,2.5,21526,32
grosse_pointe_blank,7.1,57,44,13,77,6.5,15,11,4,73,3.7,17815,85
keys_to_tulsa,4.1,8,1,7,12,0,1,0,1,0,2.9,271,28
kiss-meets-the-phantom-of-the-park,0,0,0,0,0,0,0,0,0,0,0,0,0
8_heads_in_a_duffel_bag,3.3,18,2,16,11,0,4,0,4,0,2.6,2533,34
hollow_reed,7.4,12,11,1,91,0,3,2,1,66,3.1,40,47
paradise_road,6,20,10,10,50,5.8,7,2,5,28,3.6,918,75
time_travelers_wife,5.1,151,56,95,37,4.8,34,10,24,29,2.9,189828,65
1194274-walk_all_over_me,0,4,2,2,50,0,1,0,1,0,3,609,37
brothers_kiss,0,4,4,0,100,0,2,2,0,100,2.9,289,44
chef_in_love,6.4,10,6,4,60,0,3,1,2,33,3.5,32,50
romy_and_micheles_high_school_reunion,6.2,49,34,15,69,5.9,16,9,7,56,2.8,12541,60
temptress_moon,6.4,13,8,5,61,6.2,5,2,3,40,3.5,585,67
1076267-volcano,5,38,16,22,42,4.5,10,3,7,30,2.7,14505,43
children_of_the_revolution,6.6,17,13,4,76,7,6,4,2,66,3.3,479,60
thomas-l-friedman-reporting-does-europe-hate-us2005,0,0,0,0,0,0,0,0,0,0,0,0,0
women_on_the_verge_of_a_nervous_breakdown,7.6,26,23,3,88,0,4,4,0,100,4,6254,88
broken_english,6.3,73,47,26,64,6.2,23,14,9,60,3.4,14630,61
1021015-ten_commandments,7.3,29,26,3,89,0,4,2,2,50,3.6,11440,83
ripe,4,5,0,5,0,0,2,0,2,0,0,0,0
truth_or_consequences_nm,4.5,14,5,9,35,0,2,0,2,0,3.1,880,51
warriors_of_virtue,4,10,1,9,10,0,4,0,4,0,2.9,927,45
fathers_day,4,31,6,25,19,4.8,6,2,4,33,2.5,2603,31
fifth_element,6.3,53,38,15,71,5.2,10,4,6,40,3.7,84664,84
intimate_relations,5.2,7,1,6,14,0,3,0,3,0,3.6,31,64
nowhere-in-africa,7.5,97,83,14,85,7.6,30,25,5,83,4,1773,88
losing_chase,0,4,2,2,50,0,0,0,0,0,0,0,0
sprung,4.2,9,2,7,22,0,4,0,4,0,3.5,343,70
la_promesse,7.7,19,18,1,94,7.7,8,8,0,100,3.9,599,85
le_bonheur,0,2,2,0,100,0,0,0,0,0,0,0,0
love_valour_compassion,6.1,20,13,7,65,6.5,7,5,2,71,3.6,899,70
1078942-shall_we_dance,7.9,33,30,3,90,7.6,5,4,1,80,3.9,2687,86
the-second-jungle-book-mowgli-baloo,0,0,0,0,0,0,0,0,0,0,0,0,0
twin_town,5.4,13,6,7,46,0,4,1,3,25,4.2,2298,90
addicted_to_love,5.6,30,17,13,56,6,5,3,2,60,2.8,4654,50
brassed_off,6.6,28,22,6,78,6.4,6,4,2,66,3.5,2625,68
designated_mourner,6.2,16,11,5,68,6.6,5,4,1,80,3.6,50,71
lost_world_jurassic_park,5.6,59,29,30,49,5.1,13,6,7,46,3.2,46513,55
ponette,8.1,21,19,2,90,0,3,3,0,100,4.1,956,89
schizopolis,6.5,16,10,6,62,0,3,1,2,33,3.8,1164,79
saving-shiloh,5.1,21,8,13,38,5.8,10,5,5,50,3.9,511,82
rough_magic,4.6,7,1,6,14,0,3,0,3,0,2.9,455,34
1077494-trial_and_error,5,29,12,17,41,7,6,3,3,50,2.7,602,27
1078022-buddy,5.4,19,5,14,26,6.2,6,2,4,33,2.8,1106,37
con_air,5.7,60,34,26,56,4.9,11,3,8,27,3.4,47142,77
pillow_book,6.7,26,20,6,76,0,3,3,0,100,3.8,4178,78
speed_2_cruise_control,3.1,51,1,50,1,3.2,14,1,13,7,2.2,17521,28
sudden-manhattan,5.6,6,4,2,66,0,0,0,0,0,0,0,0
wedding_bell_blues,4,5,2,3,40,0,1,0,1,0,3.3,287,54
10005205-batman,0,1,1,0,100,0,0,0,0,0,0,0,0
dream_with_the_fishes,6.1,19,11,8,57,0,3,2,1,66,3.7,452,79
for_roseanna,5.8,7,3,4,42,0,4,2,2,50,3.6,557,73
the-shape-of-water,0,0,0,0,0,0,0,0,0,0,0,0,0
1078028-hercules,7,49,41,8,83,6.8,13,10,3,76,3.2,23787,68
last_time_i_committed_suicide,0,3,1,2,33,0,0,0,0,0,0,0,0
my_best_friends_wedding,6.5,54,39,15,72,5.9,17,10,7,58,3.3,64013,72
tetsuo_ii_bodyhammer,0,3,2,1,66,0,1,1,0,100,3.4,1154,61
when-the-cats-away,7.3,16,14,2,87,0,3,3,0,100,3.8,726,76
contempt,8.4,35,33,2,94,8.1,8,7,1,87,4.1,3449,86
faceoff,7.9,60,56,4,93,8.4,15,15,0,100,3.5,62348,81
the-fall-2008,6.2,101,60,41,59,5.8,21,9,12,42,3.8,23397,85
gabbeh,7.1,19,17,2,89,7.9,8,8,0,100,3.7,394,73
men_in_black,7.5,67,61,6,91,7.3,19,16,3,84,3.5,73637,73
1077599-out_to_sea,5.3,20,7,13,35,0,4,1,3,25,3,1331,53
wild_america,4.5,18,3,15,16,4.9,5,0,5,0,2.9,3839,58
simple_wish,4.6,15,4,11,26,0,3,0,3,0,2.7,4830,40
1078021-contact,6.8,55,37,18,67,6.5,13,7,6,53,3.1,19572,74
love_serenade,6.9,9,8,1,88,0,4,3,1,75,3.6,297,75
gi_jane,6,29,16,13,55,6.4,6,3,3,50,3,11537,58
conan_the_barbarian,6.4,25,19,6,76,0,3,2,1,66,3.1,17014,66
1077847-george_of_the_jungle,5.3,50,27,23,54,6.2,14,10,4,71,2.9,21989,47
cop_land,6.5,59,42,17,71,6.1,18,13,5,72,3.1,8531,57
event_horizon,4.3,33,7,26,21,5.2,5,1,4,20,3.2,15014,63
spawn,4,40,8,32,20,4.2,9,2,7,22,2.8,18405,46
air_bud,4.9,20,9,11,45,0,4,2,2,50,2.6,11606,42
1078216-picture_perfect,5.4,40,19,21,47,5.2,9,3,6,33,2.7,4981,41
in_the_company_of_men,7.9,53,47,6,88,7.9,13,12,1,92,3.7,1900,80
free_willy_3_the_rescue,4.7,15,6,9,40,0,2,2,0,100,2.8,7843,51
career_girls,7.1,23,20,3,86,8.4,5,5,0,100,3.6,812,75
conspiracy_theory,6.2,41,21,20,51,6.1,14,6,8,42,3.2,14632,66
desperate_measures,4.1,29,5,24,17,3.8,6,0,6,0,2.9,1973,39
steel_magnolias,5.8,18,12,6,66,0,1,1,0,100,3.6,26167,88
shes_so_lovely,6,41,26,15,63,6.9,7,6,1,85,3.2,1353,56
1078030-hoodlum,5.5,19,8,11,42,7.2,6,5,1,83,3.3,2875,63
leave_it_to_beaver,4,27,5,22,18,4.4,10,2,8,20,2.6,1310,35
mimic,6.3,30,17,13,56,6.3,6,3,3,50,2.7,5478,37
excess_baggage,4.5,30,10,20,33,4.7,5,1,4,20,2.5,3231,37
kull_the_conqueror,3.6,19,5,14,26,0,4,0,4,0,2.6,1819,35
air_force_one,7,50,39,11,78,7.1,18,15,3,83,3.2,26434,62
187,5.2,27,8,19,29,5.4,5,1,4,20,3.3,3318,68
hunt_for_red_october,7.8,42,40,2,95,0,4,3,1,75,3.6,18875,84
my_own_private_idaho,7,32,27,5,84,8.7,6,6,0,100,3.6,8810,79
kiss_me_guido,5.4,15,6,9,40,5.8,5,1,4,20,3.1,439,53
star_maps,5,15,5,10,33,0,4,0,4,0,3.1,60,44
in_and_out,6.9,28,20,8,71,8,5,5,0,100,2.9,4273,47
edge,6.3,46,27,19,58,6.4,11,6,5,54,3.2,5719,67
1079516-peacemaker,6,31,13,18,41,5.4,6,0,6,0,2.8,6439,41
la_confidential,8.6,83,82,1,98,8.1,21,20,1,95,3.7,25453,90
1079716-seven_years_in_tibet,6.3,32,19,13,59,6.2,5,2,3,40,3.4,13241,71
kiss_the_girls,5.4,28,9,19,32,5.4,6,2,4,33,3.3,9940,68
soul_food,6.3,41,33,8,80,6.4,13,10,3,76,3.6,3884,85
kicked_in_the_head,4.1,9,1,8,11,0,4,0,4,0,3.1,226,45
wishmaster,3.4,27,6,21,22,2.9,5,1,4,20,2.8,3480,48
thousand_acres,4.3,47,11,36,23,3.7,14,1,13,7,3,932,40
1078955-game,7.2,43,30,13,69,7.2,11,7,4,63,3.5,23139,82
1078038-fire_down_below,3.3,26,3,23,11,3.3,7,1,6,14,2.6,3327,48
u-turn,6.1,48,28,20,58,5.2,13,6,7,46,3.1,5988,59
day_of_the_locust,6.8,8,5,3,62,0,1,1,0,100,3.6,582,75
1079208-matchmaker,5.6,26,14,12,53,0,4,2,2,50,3.3,1220,66
1079452-assignment,5.8,19,11,8,57,6.2,5,3,2,60,3.3,825,60
the-risk-is-yours,0,0,0,0,0,0,0,0,0,0,0,0,0
ulees_gold,8,48,45,3,93,7.9,13,12,1,92,3.4,607,67
ice_storm,7.6,56,46,10,82,7.3,13,10,3,76,3.6,7329,80
stag,4.4,5,2,3,40,0,0,0,0,0,0,0,0
chasing_amy,7.5,66,60,6,90,7.4,22,20,2,90,3.5,27129,81
how_to_be_a_player,3,7,1,6,14,0,1,0,1,0,3.4,1335,74
full_monty,7.6,41,39,2,95,7.6,7,7,0,100,3.3,12102,73
alive_and_kicking,6.7,6,5,1,83,0,2,2,0,100,3.2,492,45
mrs_brown,7.3,39,36,3,92,7.6,8,7,1,87,3.7,2021,76
i_know_what_you_did_last_summer,5.3,39,14,25,35,5.7,11,5,6,45,2.8,30659,49
devils_advocate,6.2,43,28,15,65,5.8,10,4,6,40,3.4,30966,78
1079403-rocketman,3.9,15,4,11,26,5.7,5,2,3,40,3,3486,69
playing_god,4.1,28,4,24,14,4.7,7,2,5,28,2.9,2458,39
house_of_yes,5.9,35,22,13,62,6.3,8,5,3,62,3.7,1730,78
fast_cheap_and_out_of_control,8.1,29,27,2,93,0,3,3,0,100,3.9,980,82
washington_square,7.2,27,22,5,81,7.6,6,4,2,66,3.4,579,58
telling_lies_in_america,6.1,14,9,5,64,5.8,6,2,4,33,3,603,40
year_of_the_horse_neil_young_and_crazy_horse_live,5.7,23,12,11,52,5.4,8,5,3,62,3.7,36,82
gattaca,7.1,55,45,10,81,6.1,11,6,5,54,3.5,36666,82
fairy-tale-a-true-story,6.2,21,11,10,52,6.7,6,3,3,50,3.3,1880,63
phantom_of_the_opera,5,165,54,111,32,4.6,37,10,27,27,3.7,70849,86
swept_from_the_sea,5.6,16,5,11,31,5,5,0,5,0,3.7,742,73
wonderland,5,98,34,64,34,4.5,32,7,25,21,3.3,3666,67
life_less_ordinary,5.5,35,14,21,40,4.3,7,1,6,14,3.1,9301,57
1093641-hurricane,7,112,93,19,83,7.3,31,29,2,93,3.7,10473,84
eves_bayou,7.5,50,40,10,80,7.9,14,12,2,85,3.9,1799,87
switchback,4.8,25,8,17,32,4.2,6,1,5,16,3,1273,45
gang_related,5.6,15,9,6,60,0,3,1,2,33,3.6,1924,73
stripes,6.6,33,29,4,87,0,4,3,1,75,0,0,0
bean,5.3,30,12,18,40,5.9,8,3,5,37,2.9,16961,56
hugo_pool,3.4,8,1,7,12,0,3,1,2,33,3,956,43
mad_city,5.3,27,10,17,37,4.9,6,1,5,16,2.9,2188,42
1079718-one_night_stand,5,28,8,20,28,6.1,7,3,4,42,2.9,964,43
tango_lesson,6,18,10,8,55,0,4,2,2,50,3.7,1178,73
welcome_to_sarajevo,6.9,25,19,6,76,7.6,5,4,1,80,3.5,985,75
deceiver,5.4,26,12,14,46,6,7,4,3,57,3.2,586,53
1080867-rainmaker,6.9,44,37,7,84,7,11,9,2,81,3.3,5792,70
boogie_nights,8.1,64,59,5,92,8.8,11,11,0,100,3.5,22528,84
1023854-witness,8.1,31,29,2,93,0,3,2,1,66,3.5,7634,76
1082887-incognito,5.1,9,3,6,33,0,0,0,0,0,0,0,0
starship_troopers,6,55,33,22,60,6.3,14,8,6,57,3,24350,67
critical_care,6.3,15,8,7,53,7.2,9,7,2,77,2.8,392,28
joy_luck_club,6.9,31,26,5,83,6.9,7,5,2,71,3.7,4795,87
chairman_of_the_board,2.4,7,1,6,14,0,0,0,0,0,0,0,0
sliding_doors,6.3,49,31,18,63,5.9,12,4,8,33,3.4,13328,74
mortal_kombat_annihilation,2.5,29,2,27,6,2.5,9,0,9,0,2.5,12426,36
truman_show,8.2,96,91,5,94,7.9,20,18,2,90,3.4,62890,82
wings_of_the_dove,7.8,28,24,4,85,9.1,7,7,0,100,3.7,1279,77
mrs_dalloway,6.4,26,16,10,61,7.3,6,5,1,83,3.3,497,59
i_love_you_i_love_you_not,5.4,5,2,3,40,0,0,0,0,0,0,0,0
red_corner,5.1,22,7,15,31,5,6,1,5,16,3,1935,49
jackal,4.2,25,3,22,12,0,4,0,4,0,3.1,12495,57
1079818-anastasia,7.1,48,41,7,85,7.1,9,7,2,77,3.2,33076,70
man_who_knew_too_little,5.4,30,12,18,40,4.9,6,2,4,33,3,4269,64
alien_3,5,39,15,24,38,5.8,7,4,3,57,3.1,30526,55
amistad,6.9,57,44,13,77,6.6,10,6,4,60,3.5,9716,75
apostle,8,44,40,4,90,8,10,9,1,90,3.6,2049,75
artemisia,6.3,22,14,8,63,6.4,6,4,2,66,3.4,390,67
1087747-bent,6.3,20,13,7,65,4.8,5,0,5,0,3.8,3465,79
les-boys,0,0,0,0,0,0,0,0,0,0,0,0,0
butcher_boy,7.5,58,46,12,79,7.8,13,11,2,84,3.7,1377,81
deconstructing_harry,7.2,33,23,10,69,7.5,6,4,2,66,3.6,5564,79
flubber,3.7,29,5,24,17,4.3,6,1,5,16,2.8,23244,43
for_richer_or_poorer,3.7,19,3,16,15,4.4,5,0,5,0,2.7,3367,47
good_will_hunting,8,69,67,2,97,7.9,16,16,0,100,3.9,63868,92
home_alone_3,4.3,21,5,16,23,5,6,2,4,33,2.6,22853,42
illgotten_gains,0,0,0,0,0,0,0,0,0,0,0,0,0
fiance,0,0,0,0,0,0,0,0,0,0,0,0,0
midnight_in_the_garden_of_good_and_evil,6.2,30,15,15,50,6.4,6,2,4,33,3.3,7144,65
mouse_hunt,5.3,28,12,16,42,4.8,7,1,6,14,2.8,9269,50
never-met-picasso,0,0,0,0,0,0,0,0,0,0,0,0,0
office_killer,3.2,16,2,14,12,0,3,0,3,0,3,371,44
other_voices_other_rooms,0,1,0,1,0,0,0,0,0,0,0,0,0
scream_2,6.8,66,53,13,80,7.4,17,16,1,94,2.9,29170,54
sweet_hereafter,8.8,52,52,0,100,8.6,16,16,0,100,4,3068,86
titanic,7.4,97,80,17,82,6.6,29,21,8,72,3.3,464576,68
tomorrow_never_dies,5.9,55,30,25,54,4.8,12,4,8,33,3.1,19587,60
twisted,2.9,132,2,130,1,3.2,36,0,36,0,2.8,2961,40
education_of_little_tree,6.3,16,10,6,62,6.5,5,2,3,40,3.6,544,70
postman,3.8,31,3,28,9,3,6,0,6,0,2.8,8147,51
horse_whisperer,6.9,52,37,15,71,6.8,13,9,4,69,3.2,7903,71
winter_guest,6.5,24,15,9,62,7.2,5,3,2,60,3.6,994,69
jackie_brown,7.3,68,58,10,85,6.3,18,11,7,61,3.5,36248,78
kundun,7.3,58,44,14,75,6.7,15,10,5,66,3.7,3355,77
mr_magoo,2.3,26,1,25,3,2.3,8,0,8,0,2.3,2618,30
big_lebowski,7.1,74,58,16,78,6.1,13,8,5,61,4,82903,93
afterglow,6.8,30,21,9,70,7.4,7,5,2,71,3,386,38
ma_vie_en_rose,7.4,20,18,2,90,7.6,5,5,0,100,4.1,3051,88
1081200-great_expectations,5.4,32,12,20,37,5.4,7,3,4,42,3.4,10607,76
3_ninjas_high_noon_at_mega_mountain,0,4,0,4,0,0,1,0,1,0,2.5,7721,32
caught_up,4.1,7,0,7,0,0,3,0,3,0,3.1,627,45
arguing_the_world,6.8,5,4,1,80,0,1,1,0,100,3.1,150,47
firestorm-1998,0,0,0,0,0,0,0,0,0,0,0,0,0
1081501-senseless,3.4,14,1,13,7,0,3,0,3,0,2.8,1704,50
wag_the_dog,7.4,70,59,11,84,7.5,19,17,2,89,3.4,8216,72
forgotten_city,0,2,0,2,0,0,0,0,0,0,0,0,0
the-leading-man,6.4,8,5,3,62,0,2,2,0,100,3.6,534,71
star_kid,5.3,12,4,8,33,0,3,1,2,33,2.5,863,32
half_baked,4.2,24,7,17,29,0,2,0,2,0,3.4,26499,82
1080990-fallen,5.3,54,22,32,40,5.1,13,5,8,38,3.4,9162,75
shooting_fish,5.8,28,16,12,57,5.2,5,1,4,20,3.5,1362,72
prophecy_ii,4.7,6,2,4,33,0,0,0,0,0,0,0,0
fallen_angels_hong_kong,7.9,19,18,1,94,0,4,4,0,100,4,4014,86
four_days_in_september,6.2,15,8,7,53,6.2,5,2,3,40,3.5,524,70
spice_world,4.5,33,9,24,27,5.1,7,1,6,14,2.1,9540,39
deep_rising,4.2,27,8,19,29,3.9,6,1,5,16,2.8,3617,42
letter_from_death_row,0,0,0,0,0,0,0,0,0,0,0,0,0
music_from_another_room,5,6,2,4,33,0,0,0,0,0,0,0,0
replacement_killers,5.4,31,12,19,38,6,6,3,3,50,3,4222,51
b_monkey,5.6,16,10,6,62,0,3,1,2,33,3.1,1126,49
the-night-flier,0,4,1,3,25,0,1,0,1,0,2.8,1507,37
blues_brothers_2000,5.1,42,19,23,45,5.5,10,4,6,40,2.7,8002,42
tokyo-fist,0,2,2,0,100,0,0,0,0,0,0,0,0
zardoz,5.2,18,8,10,44,0,1,0,1,0,3.1,2696,51
joy_ride,6.6,111,82,29,73,6.7,29,23,6,79,3.1,9370,63
wedding_singer,6.1,59,39,20,66,5.8,12,8,4,66,3.5,86088,76
sphere,4,49,6,43,12,3.8,12,1,11,8,2.7,9112,38
break-1996,0,4,3,1,75,0,0,0,0,0,0,0,0
little_city,0,3,1,2,33,0,0,0,0,0,0,0,0
palmetto,5.1,31,11,20,35,5.2,6,1,5,16,2.7,679,28
as_good_as_it_gets,7.2,75,64,11,85,7.3,21,19,2,90,3.5,30872,81
king_of_new_york,6,23,16,7,69,6.2,5,3,2,60,3.7,5329,77
1082798-men_with_guns,7.6,26,23,3,88,0,4,4,0,100,3.9,476,84
sadness_of_sex,0,0,0,0,0,0,0,0,0,0,0,0,0
twilight,5.5,196,98,98,50,5.9,36,20,16,55,4.1,256646,82
us_marshals,4.9,30,8,22,26,5,7,1,6,14,3.2,12491,59
welcome_to_woop_woop,3.8,17,5,12,29,0,2,0,2,0,3.4,280,65
love_and_death_on_long_island,8,35,31,4,88,8.3,6,6,0,100,3.2,643,54
midaq-alley,0,0,0,0,0,0,0,0,0,0,0,0,0
in_gods_hands,2.9,6,0,6,0,0,0,0,0,0,0,0,0
everest_1998,7.7,13,12,1,92,0,1,1,0,100,3.5,699,71
1082899-hush,3.4,37,4,33,10,3.2,8,0,8,0,2.9,1448,43
suicide_kings,5.4,29,10,19,34,5.4,6,2,4,33,3.4,10831,72
1082400-man_in_the_iron_mask,5.4,35,11,24,31,6.2,7,2,5,28,3.1,24313,60
newton_boys,6.3,36,22,14,61,5.7,8,3,5,37,2.9,1826,43
where_the_wild_things_are,6.9,241,176,65,73,6.4,40,26,14,65,3.4,236581,59
paulie,6.1,36,22,14,61,5.9,12,4,8,33,2.8,3810,51
cool_dry_place,5.5,13,7,6,53,0,1,0,1,0,3.2,848,54
1091981-fireworks,8.2,18,17,1,94,0,2,2,0,100,4.3,3702,91
primary_colors,7.2,74,59,15,79,6.7,21,14,7,66,3,3209,55
niagara,6.2,10,8,2,80,0,0,0,0,0,0,0,0
1082432-wide_awake,4.9,29,12,17,41,4.6,7,2,5,28,3.3,1235,65
price_above_rubies,5.9,27,15,12,55,5.7,5,2,3,40,3.1,429,51
1006416-east_of_eden,8.2,30,26,4,86,0,3,2,1,66,4,5957,90
two_girls_and_a_guy,5.6,57,30,27,52,6.4,18,10,8,55,2.8,1292,42
no_looking_back,5.3,21,8,13,38,5.4,5,1,4,20,3.5,561,66
storefront_hitchcock,7.5,8,7,1,87,0,0,0,0,0,0,0,0
proposition,7.3,123,107,16,86,7.4,31,27,4,87,3.6,20228,77
object_of_my_affection,5.8,48,24,24,50,5.6,11,5,6,45,3,6363,54
meet_the_deedles,2.4,26,1,25,3,3,5,0,5,0,2.6,1774,39
homegrown,5.9,15,7,8,46,0,3,2,1,66,3,1031,47
players_club,5,15,4,11,26,6.3,5,3,2,60,3.6,5665,82
barneys-adventure-bus,0,0,0,0,0,0,0,0,0,0,0,0,0
big,7.9,52,50,2,96,6.8,5,4,1,80,3.4,33658,73
chinese_box,6.4,21,13,8,61,6.6,5,3,2,60,3.3,700,57
lost_in_space,4.6,46,12,34,26,5.3,8,2,6,25,2.5,8293,30
heavens_burning,0,3,1,2,33,0,1,0,1,0,2.9,633,30
mercury_rising,4.2,35,6,29,17,4.6,8,1,7,12,3,7388,49
spanish_prisoner,7.4,59,52,7,88,7.2,13,12,1,92,3.7,1863,80
starved,0,0,0,0,0,0,0,0,0,0,0,0,0
last_days_of_disco,6.3,51,34,17,66,7.4,11,9,2,81,3.2,1361,58
odd_couple_ii,4.4,27,6,21,22,4.1,7,0,7,0,3.1,1418,57
my_giant,4.8,26,5,21,19,4.5,6,0,6,0,2.6,1175,30
he_got_game,6.9,60,48,12,80,6.8,18,14,4,77,3.6,8293,81
gingerbread_man,6.2,40,24,16,60,6.9,11,8,3,72,2.8,1101,27
illtown,5.3,11,6,5,54,0,1,0,1,0,3.2,34,75
slappy_and_the_stinkers,0,4,0,4,0,0,0,0,0,0,0,0,0
live_flesh,7.1,37,29,8,78,7.2,10,7,3,70,3.9,4009,86
zero_effect,6.7,38,25,13,65,6.2,5,2,3,40,3.5,1908,74
nil_by_mouth,6.2,19,12,7,63,7.6,5,4,1,80,4,1783,88
1081203-borrowers,6.6,24,17,7,70,7.5,7,6,1,85,2.8,4043,48
1033462-prince_valiant,0,0,0,0,0,0,0,0,0,0,0,0,0
i_love_you_dont_touch_me,5.4,10,4,6,40,0,1,1,0,100,3.1,352,44
leather_jacket_love_story,0,3,1,2,33,0,0,0,0,0,0,0,0
burn_hollywood_burn,2.8,36,3,33,8,2.7,6,1,5,16,2.2,601,21
kissing_a_fool,4.7,28,8,20,28,5.6,6,3,3,50,2.7,899,43
krippendorfs_tribe,3.5,36,5,31,13,3.8,7,1,6,14,2.4,910,21
kurt_and_courtney,5.3,21,12,9,57,0,3,2,1,66,3.1,1391,48
real_blonde,5.4,26,9,17,34,6.2,6,3,3,50,2.9,430,39
1082420-mr_nice_guy,5.6,27,12,15,44,6,6,3,3,50,2.9,4726,52
taste_of_cherry,7.3,30,25,5,83,7.6,10,9,1,90,4,1878,84
character,7.3,25,23,2,92,7.9,6,6,0,100,4.1,754,89
budbringeren-junk-mail,7.4,15,14,1,93,0,4,4,0,100,0,0,0
species_2,3.2,31,3,28,9,0,2,0,2,0,2.3,3562,26
major_league_back_to_the_minors,3,19,4,15,21,0,4,1,3,25,2.6,1952,31
sour_grapes,3.5,13,3,10,23,0,3,0,3,0,2.8,451,38
wild_man_blues,7.2,37,32,5,86,7.4,9,8,1,88,3.4,581,61
big_hit,5.1,39,16,23,41,6,10,5,5,50,3.1,4322,60
tarzan_and_the_lost_city,2.2,18,1,17,5,2.2,5,0,5,0,2.6,985,35
black_dog,3.1,19,2,17,10,0,3,0,3,0,3,3586,62
dancer_texas,6.6,15,12,3,80,0,3,2,1,66,3.3,531,62
friend-of-the-deceased,6.7,12,8,4,66,0,3,3,0,100,0,0,0
slumdog_millionaire,8.2,220,206,14,93,8.2,38,36,2,94,4,328969,90
1083326-les_miserables,6.9,41,31,10,75,6.6,11,6,5,54,3.6,7310,81
still_breathing,5.6,13,8,5,61,5.5,5,3,2,60,3.6,699,71
clockwatchers,6.9,24,20,4,83,6.6,5,4,1,80,3.2,947,56
deep_impact,5.7,51,24,27,47,5.9,6,2,4,33,2.9,28624,51
1081316-little_men,4.6,7,1,6,14,0,3,0,3,0,3.5,85,63
faceoff,7.9,60,56,4,93,8.4,15,15,0,100,3.5,62348,81
hanging_garden,7.3,16,15,1,93,0,4,4,0,100,3.6,485,70
lawn_dogs,6.5,18,13,5,72,0,4,1,3,25,3.8,1154,84
quest_for_camelot,5.3,21,7,14,33,5.9,6,2,4,33,3.1,4041,62
godzilla,4.7,59,15,44,25,5.7,9,3,6,33,2.6,17658,38
bulworth,7,61,46,15,75,7.6,10,8,2,80,3.1,3041,60
fear_and_loathing_in_las_vegas,5.8,45,21,24,46,4.1,6,0,6,0,3.9,75860,90
opposite_of_sex,7.1,40,33,7,82,6.9,7,4,3,57,3.1,3268,57
i_got_the_hookup,3,12,2,10,16,0,2,0,2,0,3.2,1133,68
almost_heroes,2.3,21,3,18,14,0,3,0,3,0,2.9,4626,63
hope_floats,4.9,31,7,24,22,4.8,7,0,7,0,3.3,12082,73
1114154-insomnia,7.7,166,153,13,92,7.8,33,31,2,93,3.2,18085,66
little_boy_blue,5,8,2,6,25,0,0,0,0,0,0,0,0
coyote_ugly,3.9,94,20,74,21,3.6,27,5,22,18,3.2,65988,73
1083171-perfect_murder,6.2,49,27,22,55,6.2,14,8,6,57,3.1,9130,52
beyond_silence,7.5,11,9,2,81,8,5,5,0,100,3.9,474,83
six_days_seven_nights,5.4,38,14,24,36,5.4,6,0,6,0,2.7,10008,41
cant_hardly_wait,5.4,45,20,25,44,5.4,12,5,7,41,3.1,11719,60
1084229-cousin_bette,6,21,10,11,47,5.6,5,1,4,20,3,408,38
high_art,6.8,42,30,12,71,7.2,7,4,3,57,3.7,2153,76
land_girls,6.7,17,11,6,64,6.1,7,2,5,28,3.3,693,54
passion_in_the_desert,6.1,20,13,7,65,0,4,1,3,25,3.2,162,55
the-children-of-heaven,7.6,25,21,4,84,7.6,5,4,1,80,4.4,3834,94
dear_jesse,6.8,6,5,1,83,0,1,1,0,100,3.8,29,100
dream_for_an_insomniac,5,10,5,5,50,0,2,0,2,0,3.6,1167,74
hav_plenty,5.2,21,8,13,38,6.6,6,4,2,66,3.9,465,80
henry_fool,7.4,26,22,4,84,0,3,2,1,66,3.8,1375,78
mr_jealousy,6.5,12,8,4,66,0,4,2,2,50,3.3,437,59
mulan,7.5,72,62,10,86,7,14,10,4,71,3.4,52938,78
resurrection_man,0,3,0,3,0,0,0,0,0,0,0,0,0
xfiles_fight_the_future,6,68,43,25,63,5.9,15,8,7,53,3.3,13283,69
i_went_down,7.2,19,16,3,84,0,4,2,2,50,4.2,202,88
dr_dolittle,5.2,49,21,28,42,5.5,8,4,4,50,2.8,23847,46
1083436-1083436-out_of_sight,7.9,69,64,5,92,8,14,13,1,92,3.2,11285,65
picnic_at_hanging_rock,8.3,29,27,2,93,9.7,5,5,0,100,4,3210,84
smoke_signals,7.3,29,25,4,86,8.1,5,5,0,100,3.9,2767,83
viagem-ao-principio-do-mundo-journey-to-the-beginning-of-the-world,6.2,5,3,2,60,0,0,0,0,0,0,0,0
buffalo_66,7,40,31,9,77,7.1,7,5,2,71,3.8,7504,87
armageddon,5.1,77,32,45,41,3.8,17,3,14,17,3.5,105398,77
lethal_weapon_4,5.9,61,33,28,54,6.1,12,6,6,50,3.3,20840,70
1083410-madeline,6.5,26,17,9,65,6.5,6,4,2,66,2.6,3549,45
small_soldiers,6.2,41,19,22,46,6.8,12,6,6,50,2.8,9855,46
pi,7.2,49,42,7,85,6.7,11,8,3,72,3.8,33850,86
something_more,0,2,0,2,0,0,1,0,1,0,3.1,233,47
plan-9-from-outer-space,4.9,30,19,11,63,0,1,1,0,100,2.8,6105,46
wings_of_desire,8.5,39,38,1,97,7.5,6,5,1,83,4.4,9110,94
1000642-all_quiet_on_the_western_front,8.6,32,31,1,96,7.8,5,5,0,100,3.8,3797,85
spirit_stallion_of_the_cimarron,6.4,125,86,39,68,6.9,29,23,6,79,3.3,8302,72
grand_hotel,7.4,28,24,4,85,7.6,5,5,0,100,3.8,1661,77
cavalcade,6.7,14,9,5,64,0,4,4,0,100,3,314,35
1014481-mutiny_on_the_bounty,8.2,28,26,2,92,7.5,6,5,1,83,3.7,1846,79
great_ziegfeld,6,21,12,9,57,6,5,3,2,60,3.4,704,60
life_of_emile_zola,7,20,14,6,70,7.2,5,4,1,80,3.6,620,72
1024312-you_cant_take_it_with_you,7.3,27,26,1,96,0,4,4,0,100,4,2934,87
how_green_was_my_valley,7.8,34,30,4,88,7.2,5,5,0,100,3.9,1995,83
mrs_miniver,7.6,22,19,3,86,8.2,5,5,0,100,3.9,1307,85
going_my_way,7,19,14,5,73,0,4,3,1,75,3.8,1251,80
lost_weekend,8.2,24,24,0,100,0,4,4,0,100,4,2562,86
best_years_of_our_lives,8.6,35,34,1,97,8.1,8,8,0,100,4.2,3330,91
gentlemans_agreement,7,30,25,5,83,6.8,5,4,1,80,3.8,1308,79
1075422-hamlet,8.2,54,51,3,94,7.2,14,11,3,78,3.8,5816,86
keep-drinking-men,0,0,0,0,0,0,0,0,0,0,0,0,0
under-the-carp-banner2006,0,0,0,0,0,0,0,0,0,0,0,0,0
1007931-from_here_to_eternity,8,40,35,5,87,7.9,7,6,1,85,3.9,4410,83
on_the_waterfront,9,49,49,0,100,8.9,10,10,0,100,4.2,11904,94
back_to_the_future,8.4,54,52,2,96,7.3,6,5,1,83,3.8,126816,88
west_side_story,8.1,49,45,4,91,8,7,6,1,85,3.5,18648,82
tom_jones,7.8,26,21,5,80,0,4,3,1,75,3.3,1389,60
1013162-man_for_all_seasons,7.8,27,23,4,85,0,4,3,1,75,4,2887,86
in_the_heat_of_the_night,8.1,28,27,1,96,0,4,4,0,100,3.9,4274,90
oliver,7.7,25,21,4,84,0,4,3,1,75,3.4,9490,72
midnight_cowboy,8.3,49,44,5,89,6.8,6,5,1,83,3.9,8994,87
french_connection,8.5,45,44,1,97,8.2,6,6,0,100,3.8,8751,86
1017776-rocky,8.1,41,38,3,92,7.6,5,4,1,80,3.2,165793,65
kramer_vs_kramer,7.9,34,30,4,88,7.4,6,5,1,83,3.7,9401,85
ordinary_people,7.9,32,29,3,90,7.5,6,5,1,83,3.8,5284,86
chariots_of_fire,7.4,36,31,5,86,7.4,6,5,1,83,3.6,7456,77
terms_of_endearment,7.4,35,31,4,88,7.1,5,4,1,80,3.7,7594,82
out_of_africa,6.2,32,20,12,62,6.5,6,4,2,66,3.7,10166,84
last_emperor,7.9,44,40,4,90,7.6,9,7,2,77,3.7,7466,86
rain_man,7.6,54,47,7,87,4.5,7,2,5,28,3.8,42473,88
driving_miss_daisy,7,41,32,9,78,7.9,8,8,0,100,3.4,7698,79
take_the_money_and_run,6.9,13,12,1,92,0,1,0,1,0,0,0,0
klute,8,27,26,1,96,0,3,2,1,66,3.7,1593,78
repo_man,7.9,37,36,1,97,0,4,4,0,100,3.4,5166,75
metropolitan,7.4,25,22,3,88,6.5,6,4,2,66,3.9,1143,83
labyrinth,6,32,19,13,59,6.2,6,3,3,50,3.8,81222,85
breakfast_club,7.5,42,38,4,90,6.2,6,4,2,66,3.9,93109,90
nightmare_on_elm_street_2_freddys_revenge,4.8,23,10,13,43,0,2,2,0,100,3,19841,55
nightmare_on_elm_street_3_a_dream_warriors,5.9,31,22,9,70,0,4,1,3,25,3.1,21954,68
nightmare_on_elm_street_4_the_dream_master,5.3,25,14,11,56,0,4,2,2,50,3,19043,60
nightmare_on_elm_street_5_the_dream_child,4.1,27,8,19,29,0,4,1,3,25,2.9,17837,56
freddys_dead_the_final_nightmare,3.9,25,5,20,20,0,4,3,1,75,3,12382,54
friday_the_13th_part_1,5.6,45,27,18,60,0,4,2,2,50,3.2,25534,66
friday_the_13th_part_2,4.4,30,10,20,33,0,1,0,1,0,3.1,13685,58
friday_the_13th_part_3,3.5,22,3,19,13,0,0,0,0,0,0,0,0
friday-the-13th-the-final-chapter,4.3,21,5,16,23,0,0,0,0,0,0,0,0
friday_the_13th_part_5_a_new_beginning,3.3,17,3,14,17,0,0,0,0,0,0,0,0
friday_the_13th_part_6_jason_lives,5.1,24,13,11,54,0,0,0,0,0,0,0,0
friday_the_13th_part_7_the_new_blood,4.5,16,4,12,25,0,0,0,0,0,0,0,0
friday_the_13th_part_8_jason_takes_manhattan,2.9,20,2,18,10,0,1,0,1,0,2.8,9749,45
1179254-halloween,4.1,101,26,75,25,3.9,19,3,16,15,3.3,79946,64
halloween_ii,4.3,30,8,22,26,4.4,5,1,4,20,3.3,16555,67
halloween_3_season_of_the_witch,4.2,15,5,10,33,0,2,1,1,50,2.2,7355,28
halloween_4_the_return_of_michael_myers,3.8,22,5,17,22,0,4,0,4,0,3.1,13190,61
halloween_5_the_revenge_of_michael_myers,3.6,21,3,18,14,0,2,1,1,50,3,11908,55
prom_night,2.8,60,5,55,8,2.4,9,1,8,11,3,51435,46
hello_mary_lou_prom_night_2,4,8,3,5,37,0,0,0,0,0,0,0,0
prom_night_3_the_last_kiss,0,3,0,3,0,0,0,0,0,0,0,0,0
prom_night_4_deliver_us_from_evil,2.1,5,0,5,0,0,0,0,0,0,0,0,0
bride_of_chucky,5.3,30,13,17,43,0,4,1,3,25,2.6,20874,52
childs_play_2,4.2,13,5,8,38,0,1,1,0,100,2.8,13499,52
childs_play_3,4.3,11,3,8,27,0,1,0,1,0,2.8,12064,47
1016513-poltergeist,7.1,49,42,7,85,0,4,3,1,75,3.4,15891,74
poltergeist_ii_the_other_side,4.7,17,7,10,41,0,1,0,1,0,0,0,0
poltergeist_iii,3.6,14,2,12,14,0,0,0,0,0,0,0,0
exorcist,7.7,43,36,7,83,6.6,7,5,2,71,3.7,49968,83
exorcist_2_the_heretic,3.6,17,4,13,23,0,0,0,0,0,0,0,0
exorcist_3,5.4,27,16,11,59,0,1,0,1,0,2.9,4879,55
lethal_weapon,7.3,40,36,4,90,7.4,8,7,1,87,3.6,33975,81
lethal_weapon,7.3,40,36,4,90,7.4,8,7,1,87,3.6,33975,81
lethal_weapon_3,5.6,39,22,17,56,4.7,8,3,5,37,3.2,20151,68
gremlins,6.8,41,32,9,78,5,5,2,3,40,3.4,31525,70
gremlins_2_the_new_batch,6.4,34,22,12,64,6.4,6,4,2,66,3,18308,58
goonies,5.9,39,25,14,64,0,3,2,1,66,3.8,89625,88
mask_of_zorro,7.1,66,54,12,81,6.5,13,10,3,76,3.3,31107,70
polish_wedding,4.9,35,15,20,42,5.5,9,4,5,44,3,896,51
this_world_then_the_fireworks,3.7,5,1,4,20,0,0,0,0,0,0,0,0
soylent_green,6,31,22,9,70,0,3,0,3,0,3.5,5747,71
back_to_the_future_2,6,40,26,14,65,4.2,6,2,4,33,3.5,73208,80
back_to_the_future_3,6.3,38,27,11,71,5.5,7,3,4,42,3.4,66354,74
1016584-poseidon_adventure,6.8,23,18,5,78,0,1,0,1,0,3.3,7876,72
freaky_friday,7,140,123,17,87,7,34,29,5,85,2.9,73112,60
absentminded_professor,7.2,20,16,4,80,0,2,2,0,100,3.2,1425,61
apple_dumpling_gang_rides_again,0,3,0,3,0,0,0,0,0,0,0,0,0
march_of_the_wooden_soldiers,8.4,12,12,0,100,0,2,2,0,100,3.6,865,78
bambi,8,38,34,4,89,0,4,4,0,100,3.4,39873,68
1018639-seven_samurai,9.2,49,49,0,100,8.6,10,10,0,100,4.5,29509,97
1005199-dangerous_liaisons,7.7,27,25,2,92,6.5,6,5,1,83,3.7,11359,84
1006364-dune,6.1,26,16,10,61,0,2,0,2,0,3.4,17715,67
last_temptation_of_christ,7.3,46,38,8,82,7.5,7,6,1,85,3.7,7365,83
godfather_part_iii,6.4,53,35,18,66,6.9,8,6,2,75,3.7,68556,79
rapture,6.5,24,16,8,66,0,2,1,1,50,3.2,627,61
1012611-lolita,8,38,37,1,97,0,2,2,0,100,3.7,11593,80
disturbing_behavior,4.4,33,10,23,30,5.2,6,2,4,33,2.7,4794,43
1083535-mafia,4,42,6,36,14,4.4,7,0,7,0,2.7,1995,47
saving_private_ryan,8.2,92,84,8,91,8.1,19,17,2,89,4,139463,92
billys_hollywood_screen_kiss,6.5,20,13,7,65,0,4,0,4,0,3.4,686,59
east-palace-west-palace,6.3,5,3,2,60,0,0,0,0,0,0,0,0
million_dollar_duck,3.5,5,0,5,0,0,1,0,1,0,0,0,0
barefoot_executive,0,4,4,0,100,0,0,0,0,0,0,0,0
black_cauldron,5.8,27,16,11,59,6.2,5,3,2,60,3.1,5461,53
1002497-black_hole,5.1,26,11,15,42,0,3,2,1,66,3,2357,45
blackbeards_ghost,5.6,9,7,2,77,0,1,1,0,100,3.3,1038,69
blank_check,2.6,7,1,6,14,0,0,0,0,0,0,0,0
candleshoe,0,1,1,0,100,0,0,0,0,0,0,0,0
cat_from_outer_space,0,4,1,3,25,0,0,0,0,0,0,0,0
cheetah,5.5,7,3,4,42,0,1,1,0,100,3.3,357,59
computer_wore_tennis_shoes,5.6,5,3,2,60,0,0,0,0,0,0,0,0
condorman,3.9,12,3,9,25,0,1,1,0,100,2.9,1334,49
d2_the_mighty_ducks,3.8,13,2,11,15,0,1,0,1,0,2.9,13731,55
darby_ogill_and_the_little_people,6.9,13,13,0,100,0,1,1,0,100,3.5,2183,71
devil_and_max_devlin,3.9,8,1,7,12,0,0,0,0,0,0,0,0
far_off_place,4.9,9,3,6,33,0,2,0,2,0,3.3,2508,62
flight_of_the_navigator,5.7,7,5,2,71,0,0,0,0,0,0,0,0
gnomemobile,0,1,1,0,100,0,1,1,0,100,3.4,654,62
the-great-mouse-detective,6.8,15,12,3,80,0,2,2,0,100,3.3,8687,70
happiest_millionaire,0,4,2,2,50,0,1,0,1,0,3.8,694,78
herbie_goes_bananas,0,4,1,3,25,0,1,1,0,100,2.9,2642,53
herbie_goes_to_monte_carlo,5,8,5,3,62,0,0,0,0,0,0,0,0
1045250-hocus_pocus,4.1,21,6,15,28,0,3,0,3,0,3.1,21690,67
honey_i_blew_up_the_kid,4.9,16,7,9,43,0,2,1,1,50,2.5,10297,32
honey_i_shrunk_the_kids,6.1,30,22,8,73,0,4,3,1,75,2.9,22644,47
hot_lead_and_cold_feet,0,1,1,0,100,0,0,0,0,0,0,0,0
in_search_of_the_castaways,0,4,3,1,75,0,0,0,0,0,0,0,0
homeward_bound_the_incredible_journey,6.5,22,19,3,86,6.9,8,7,1,87,3.2,15019,66
negotiater,0,0,0,0,0,0,0,0,0,0,0,0,0
1083414-parent_trap,7,34,27,7,79,6.5,7,4,3,57,3.1,41455,67
baseketball,5,49,20,29,40,4.5,13,3,10,23,3.2,19777,74
full-tilt-boogie,0,0,0,0,0,0,0,0,0,0,0,0,0
governess,6.4,33,22,11,66,7,6,4,2,66,3.2,534,49
1091957-seventh_heaven,5.3,7,4,3,57,0,1,1,0,100,3.4,192,62
roger_and_me,8.8,27,27,0,100,0,0,0,0,0,0,0,0
purple_rose_of_cairo,7.7,29,26,3,89,0,0,0,0,0,0,0,0
out_of_the_past,8.6,25,24,1,96,8.6,5,5,0,100,4.2,2206,91
1006037-doctor_zhivago,7.2,32,27,5,84,6,5,3,2,60,3.8,11535,85
fanny_and_alexander,8.9,33,33,0,100,8.4,11,11,0,100,4.4,5627,93
trip_to_bountiful,7.2,7,7,0,100,0,1,1,0,100,4,434,82
tender_mercies,7.3,20,17,3,85,0,0,0,0,0,0,0,0
and_the_band_played_on,7.3,8,8,0,100,0,0,0,0,0,0,0,0
burbs,5.2,13,6,7,46,0,2,1,1,50,3.3,10248,68
1007073-fandango,6.3,6,3,3,50,0,0,0,0,0,0,0,0
night_porter,5.6,20,13,7,65,0,4,1,3,25,3.6,1475,73
mephisto,6.9,16,11,5,68,5.5,5,2,3,40,3.9,757,86
blue_velvet,8.4,33,30,3,90,0,4,2,2,50,4,25218,88
journey_of_natty_gann,6.7,13,12,1,92,0,3,3,0,100,3.5,1251,73
1031385-jungle_book,7.3,27,24,3,88,0,2,1,1,50,3.5,35715,70
kidnap2008,0,0,0,0,0,0,0,0,0,0,0,0,0
lady_and_the_tramp,7.4,31,27,4,87,0,4,1,3,25,3.5,37042,73
1012450-little_mermaid,8,51,46,5,90,7.3,7,6,1,85,3.6,80670,83
mighty_ducks,3.8,25,2,23,8,3.2,5,0,5,0,3.1,14328,64
muppet_christmas_carol,6,30,20,10,66,4.4,7,3,4,42,0,0,0
newsies,4.5,23,7,16,30,3.6,7,1,6,14,3.8,10436,88
1036674-101_dalmatians,8,37,36,1,97,7.6,5,5,0,100,3.3,29711,63
one_magic_christmas,5.4,9,5,4,55,0,1,0,1,0,3.4,844,66
1128577-peter_pan,6.8,132,100,32,75,6.3,33,23,10,69,3.3,47413,68
1016534-popeye,5.8,27,15,12,55,0,4,2,2,50,2.6,6384,39
rescuers_down_under,6,22,14,8,63,6.5,5,3,2,60,3.2,8757,62
rescuers,6.6,25,21,4,84,0,3,3,0,100,3.2,7689,66
return_of_jafar,3.6,9,2,7,22,0,0,0,0,0,0,0,0
1017488-return_to_oz,5.7,20,11,9,55,0,3,1,2,33,3.1,14348,62
rocketeer,5.8,50,30,20,60,5.8,9,5,4,55,2.9,8053,54
shaggy_da,5.4,8,4,4,50,0,1,0,1,0,3.2,263,55
1019187-sleeping_beauty,7.8,32,29,3,90,0,4,3,1,75,3.4,42607,75
something_wicked_this_way_comes,6.1,23,13,10,56,0,4,3,1,75,3.4,2097,64
son_of_flubber,6.2,6,5,1,83,0,0,0,0,0,0,0,0
song_of_the_south,5.6,7,3,4,42,0,2,0,2,0,3.6,1559,77
1019641-splash,6.9,35,32,3,91,5.6,5,3,2,60,3,12492,52
squanto_a_warriors_tale,5.6,9,5,4,55,0,2,0,2,0,3.3,515,62
steamboat-willie,0,0,0,0,0,0,0,0,0,0,0,0,0
tall_tale_the_unbelievable_adventure,5.5,9,4,5,44,0,1,1,0,100,0,0,0
tex,6.9,11,9,2,81,0,3,2,1,66,3.5,695,66
tron,6,37,25,12,67,0,4,1,3,25,3.3,14666,69
swing_kids,4.6,12,4,8,33,0,3,1,2,33,3.5,4819,79
halloween_h2o,5.5,54,28,26,51,5.9,10,5,5,50,2.8,14935,57
la_story,7.4,32,30,2,93,7.8,7,7,0,100,3.2,3117,70
jerk,6.5,30,25,5,83,0,4,2,2,50,3.6,10847,83
dead_men_dont_wear_plaid,6.5,22,17,5,77,0,0,0,0,0,0,0,0
man_with_two_brains,6,20,14,6,70,0,1,0,1,0,3,4360,57
1037642-grand_canyon,6.9,24,18,6,75,0,2,2,0,100,3.4,1857,65
1031376-graveyard_shift,3.8,8,1,7,12,0,0,0,0,0,0,0,0
outsiders,6.1,31,20,11,64,4.7,7,2,5,28,3.6,24069,81
indiana_jones_and_the_temple_of_doom,7.2,59,50,9,84,6.5,7,4,3,57,3.7,87518,80
lord_of_the_rings_the_return_of_the_king,8.6,239,225,14,94,8.6,43,42,1,97,3.7,288649,83
1000055-1984,6.4,14,11,3,78,0,1,1,0,100,3.5,17133,70
maximum_overdrive,2.9,11,2,9,18,0,0,0,0,0,0,0,0
needful_things,4,22,6,16,27,0,3,0,3,0,3,2983,48
cujo,5.6,27,16,11,59,0,0,0,0,0,0,0,0
1004047-children_of_the_corn,4.1,22,8,14,36,0,0,0,0,0,0,0,0
addams_family,5.6,39,23,16,58,4.1,7,1,6,14,3.2,28704,65
ever_after_a_cinderella_story,7.5,61,55,6,90,6.8,17,13,4,76,3.5,71637,81
snake_eyes,5.2,64,26,38,40,4.9,14,6,8,42,2.8,8922,40
first_love_last_rites,6.1,8,3,5,37,0,0,0,0,0,0,0,0
safe_men,6,19,11,8,57,0,3,0,3,0,3.4,851,60
the-saltmen-of-tibet,0,0,0,0,0,0,0,0,0,0,0,0,0
atlantic_city,8.7,19,19,0,100,0,0,0,0,0,0,0,0
autumn_sonata,8,19,18,1,94,0,1,1,0,100,4.1,2226,90
whos_afraid_of_virginia_woolf,8.6,31,30,1,96,0,4,3,1,75,4.1,5164,91
adventures_in_babysitting,6.2,21,16,5,76,0,1,0,1,0,3.2,12565,64
1023316-weird_science,5.6,25,14,11,56,0,3,1,2,33,3.2,14712,69
dr_dolittle,5.2,49,21,28,42,5.5,8,4,4,50,2.8,23847,46
1071708-nutty_professor,6,51,34,17,66,6.7,15,13,2,86,2.9,25286,50
charlottes_web,7,142,111,31,78,6.9,35,25,10,71,3.3,39179,67
watership_down,7,27,22,5,81,0,2,1,1,50,3.6,5277,82
secret_of_nimh,6.8,18,17,1,94,6.5,5,4,1,80,3.5,7964,79
dark_crystal,6.1,30,21,9,70,0,2,1,1,50,3.6,35382,78
american_tail,6.2,24,15,9,62,4.8,6,2,4,33,3.3,13516,68
american_tail_fievel_goes_west,5.4,9,3,6,33,0,2,1,1,50,3.2,16427,58
1012164-legend,5.4,21,11,10,52,0,1,0,1,0,3.5,26271,73
sixteen_candles,7,31,27,4,87,6.2,5,3,2,60,3.7,44572,84
pretty_in_pink,6.3,30,24,6,80,0,4,3,1,75,3.5,37255,81
st_elmos_fire,4.7,29,13,16,44,0,0,0,0,0,0,0,0
clan_of_the_cave_bear,3.7,8,1,7,12,0,1,0,1,0,2.9,1148,48
house_2_the_second_story,3,9,0,9,0,0,0,0,0,0,0,0,0
the-gods-must-be-crazy,7.4,19,18,1,94,0,1,1,0,100,3.5,7965,78
gods_must_be_crazy_2,5.1,11,6,5,54,0,2,1,1,50,3.4,2600,69
air-bud-golden-receiver,4,17,1,16,5,0,3,0,3,0,2.7,7798,41
how_stella_got_her_groove_back,5.5,47,23,24,48,5.8,12,7,5,58,3.1,4439,72
slums_of_beverly_hills,6.9,58,46,12,79,7.3,13,12,1,92,3.3,1834,64
1084447-best_man,5.7,7,4,3,57,0,2,1,1,50,2.7,49,38
chambermaid_on_the_titanic,6.5,16,13,3,81,0,1,1,0,100,0,0,0
henry-portrait-of-a-serial-killer-part-2,0,0,0,0,0,0,0,0,0,0,0,0,0
henry-portrait-of-a-serial-killer,7.3,41,36,5,87,6.5,7,6,1,85,3.6,2890,72
hush_little_baby_dont_you_cry,0,0,0,0,0,0,0,0,0,0,0,0,0
neverending_story_3_the_escape_from_fantasia,0,3,1,2,33,0,0,0,0,0,0,0,0
neverending_story_2_the_the_next_chapter,3.3,6,0,6,0,0,0,0,0,0,0,0,0
attack-of-the-killer-tomatoes,3.9,11,3,8,27,0,0,0,0,0,0,0,0
surf_nazis_must_die,0,4,0,4,0,0,0,0,0,0,0,0,0
your_friends_and_neighbors,7,55,42,13,76,6.4,20,13,7,65,3.3,1418,60
1083688-return_to_paradise,6.6,44,31,13,70,6.8,11,8,3,72,3.5,1723,76
dance_with_me,5.4,40,19,21,47,5.2,11,5,6,45,3.2,7621,68
dead_man_on_campus,3.6,34,5,29,14,2.8,11,0,11,0,2.7,3796,50
wrongfully_accused,3.8,31,7,24,22,2.9,6,0,6,0,2.8,2483,56
next_stop_wonderland,6.8,41,30,11,73,5.7,7,3,4,42,3.5,910,70
all_i_wanna_do,6.8,12,8,4,66,0,3,1,2,33,3.5,2267,69
1014781-navigator,6.5,5,4,1,80,0,0,0,0,0,0,0,0
beetlejuice,7,42,34,8,80,6.4,7,5,2,71,3.4,84134,77
new-orleans-exposed-before-and-after-katrina,0,0,0,0,0,0,0,0,0,0,0,0,0
rope,7.8,31,30,1,96,0,2,1,1,50,4,9199,89
family_plot,7,20,19,1,95,0,2,2,0,100,3.3,1981,57
frenzy,7.4,30,26,4,86,0,2,2,0,100,3.6,3790,74
topaz,6.4,17,12,5,70,0,1,1,0,100,3,1779,39
torn_curtain,6.5,16,13,3,81,0,1,0,1,0,3.3,2910,55
marnie,6.8,19,16,3,84,0,1,0,1,0,0,0,0
1024191-wrong_man,8.3,18,16,2,88,0,1,0,1,0,3.6,2616,72
1013209-man_who_knew_too_much,7.7,28,25,3,89,0,3,2,1,66,0,0,0
trouble_with_harry,7.4,19,17,2,89,0,1,1,0,100,3.6,3827,73
i_confess,7.2,20,17,3,85,0,3,2,1,66,3.6,2474,70
strangers_on_a_train,8.7,40,39,1,97,7.3,5,4,1,80,4,9106,91
1019777-stage_fright,7,16,14,2,87,0,3,2,1,66,3.4,2015,61
54,4.1,62,8,54,12,3.4,14,1,13,7,2.8,4129,45
i_married_a_strange_person,6.1,9,7,2,77,0,1,1,0,100,3.8,688,80
why_do_fools_fall_in_love,5.8,54,29,25,53,6.5,19,13,6,68,3.5,1989,73
merry_war,7,21,18,3,85,0,4,4,0,100,3.2,753,50
see_the_sea,7.3,8,8,0,100,0,2,2,0,100,3.4,370,61
willow,5.4,26,12,14,46,0,4,0,4,0,3.4,36518,76
untouchables,7.2,42,34,8,80,7.9,7,6,1,85,3.8,40677,87
1083480-dirty_work,3.9,30,5,25,16,3.5,7,0,7,0,3.1,3838,66
knock_off,2.9,38,3,35,7,3.6,9,2,7,22,2.6,1992,32
firelight,5.2,13,6,7,46,0,3,2,1,66,3.8,672,81
1171877-phoenix,0,0,0,0,0,0,0,0,0,0,0,0,0
1022317-under_capricorn,5.9,6,4,2,66,0,2,1,1,50,3,851,37
paradine_case,6.2,8,6,2,75,0,1,1,0,100,3.2,1208,46
lifeboat,7.8,20,19,1,95,0,3,2,1,66,3.8,2621,84
1018688-shadow_of_a_doubt,8.9,30,30,0,100,0,4,4,0,100,4,5376,89
saboteur,6.7,14,11,3,78,0,1,0,1,0,3.6,2467,72
mr_and_mrs_smith,6,202,116,86,57,5.6,39,18,21,46,3.4,230941,63
guilty_by_suspicion,6.2,16,11,5,68,0,2,1,1,50,3.2,728,51
1010889-jamaica_inn,5.5,10,7,3,70,0,1,0,1,0,3,1259,38
1011813-lady_vanishes,8.3,33,32,1,96,0,3,3,0,100,4,4078,87
young_and_innocent,7.5,13,13,0,100,0,2,2,0,100,3.4,889,61
1018044-sabotage,7.3,7,7,0,100,0,1,1,0,100,3.5,1459,68
1018483-secret_agent,7.6,10,10,0,100,0,0,0,0,0,0,0,0
1013209-man_who_knew_too_much,7.7,28,25,3,89,0,3,2,1,66,0,0,0
number_17,0,2,0,2,0,0,0,0,0,0,0,0,0
rich_and_strange,6.4,10,7,3,70,0,1,1,0,100,0,0,0
1046655-skin_game,0,3,0,3,0,0,2,0,2,0,2.7,145,27
juno_and_the_paycock,5.1,7,4,3,57,0,2,0,2,0,0,0,0
1083171-perfect_murder,6.2,49,27,22,55,6.2,14,8,6,57,3.1,9130,52
manxman,0,2,2,0,100,0,1,1,0,100,3.1,502,37
1002540-blackmail,6.7,9,8,1,88,0,1,1,0,100,3.4,1310,63
1057837-champagne,0,1,0,1,0,0,0,0,0,0,0,0,0
the-farmers-wife2005,0,0,0,0,0,0,0,0,0,0,0,0,0
1202807-easy_virtue,5.8,120,63,57,52,5.8,26,13,13,50,3.1,16900,48
ring,6.6,169,120,49,71,6.3,32,18,14,56,3,146246,50
1205668-lodger,3.6,23,4,19,17,2.5,6,0,6,0,2.9,1023,36
the-pleasure-garden,0,1,1,0,100,0,0,0,0,0,0,0,0
1083659-rounders,6.2,76,49,27,64,5,19,8,11,42,3.7,21780,86
cube,6.1,33,20,13,60,6,6,3,3,50,3.5,22869,75
digging_to_china,4.4,7,3,4,42,0,1,0,1,0,3.7,506,70
kinsey,7.6,187,168,19,89,7.9,39,36,3,92,3.4,6162,72
one_mans_hero,4.8,8,3,5,37,0,1,0,1,0,3.1,305,48
simon_birch,5.8,32,14,18,43,5.4,6,2,4,33,3.4,8747,76
without_limits,6.5,37,29,8,78,6.8,15,13,2,86,4,1947,88
seven_beauties,8.2,9,8,1,88,0,1,1,0,100,4,557,87
1020710-swept_away,5.9,16,11,5,68,0,2,2,0,100,3.7,857,77
my_bodyguard,6.5,25,21,4,84,0,4,3,1,75,3.4,1236,67
class,4.7,12,3,9,25,0,2,1,1,50,3,1523,47
grandview_usa,0,1,0,1,0,0,0,0,0,0,0,0,0
broadcast_news,8.1,38,37,1,97,7.8,7,7,0,100,3.5,2524,71
allnighter,2.5,7,0,7,0,0,3,0,3,0,2.9,329,39
working_girl,6.7,36,30,6,83,7.2,7,6,1,85,3.1,6043,61
stars_and_bars,0,1,1,0,100,0,0,0,0,0,0,0,0
married_to_the_mob,7.2,22,19,3,86,0,0,0,0,0,0,0,0
say_anything,8.1,38,38,0,100,7.9,6,6,0,100,3.6,20891,82
1029161-my_blue_heaven,5.5,16,11,5,68,0,1,1,0,100,3,2634,54
men_dont_leave,6.6,16,12,4,75,0,2,1,1,50,3.4,202,54
heroes-and-villians,0,0,0,0,0,0,0,0,0,0,0,0,0
toys,4.1,22,6,16,27,0,3,0,3,0,2.6,6312,39
young_doctors_in_love,4.2,6,0,6,0,0,1,0,1,0,2.7,366,33
1015940-parasite,2.2,5,0,5,0,0,0,0,0,0,0,0,0
no_small_affair,5.7,6,4,2,66,0,0,0,0,0,0,0,0
36th-chamber-of-shaolin-shao-lin-san-shi-liu-fang,0,1,0,1,0,0,0,0,0,0,0,0,0
blame_it_on_rio,2.9,22,2,20,9,0,3,0,3,0,2.8,1097,36
filth_and_wisdom,3.9,58,15,43,25,4.2,23,7,16,30,3,1070,42
one_crazy_summer,5.6,15,9,6,60,0,2,1,1,50,3.3,3309,62
1094041-last_night,7.2,49,41,8,83,7.1,9,7,2,77,3.8,1691,84
seventh_sign,3.7,16,3,13,18,0,1,0,1,0,3.1,3031,55
1023286-were_no_angels,5.1,18,9,9,50,0,1,1,0,100,2.9,2176,43
1033647-nothing_but_trouble,2.2,10,1,9,10,0,1,0,1,0,0,0,0
butchers_wife,3.8,13,3,10,23,0,2,0,2,0,2.7,1218,30
mortal_thoughts,5.6,13,8,5,61,0,2,1,1,50,2.9,1404,33
few_good_men,6.8,42,35,7,83,7.5,8,8,0,100,3.6,26934,83
indecent_proposal,4.7,35,13,22,37,0,3,1,2,33,2.9,7358,50
permanent_midnight,5.7,51,30,21,58,6.4,11,7,4,63,3.2,1302,55
one_true_thing,7.2,60,53,7,88,6.7,18,15,3,83,3.4,2813,65
rush_hour,6,62,37,25,59,5.5,14,7,7,50,3.4,73231,79
sixstring_samurai,6,20,12,8,60,0,1,0,1,0,3.7,2140,75
soldiers_daughter_never_cries,7,24,19,5,79,7.3,7,5,2,71,3.4,482,62
ronin,6.3,60,41,19,68,5.8,14,8,6,57,3.5,26379,76
urban_legend,4.3,48,10,38,20,4.1,12,2,10,16,2.7,15231,46
clay_pigeons,6.2,51,32,19,62,5,10,2,8,20,3.4,2336,67
monument_ave,7,19,17,2,89,0,4,4,0,100,3.3,386,58
pecker,5.7,43,23,20,53,4.7,6,1,5,16,3.2,3201,63
sheltering_sky,5.2,22,10,12,45,5,7,3,4,42,3.8,1679,79
bandit_queen,7.5,25,25,0,100,7.6,10,10,0,100,3.6,1049,72
if1968,7.9,30,29,1,96,0,4,3,1,75,4.1,2971,88
fiendish_plot_of_dr_fu_manchu,3.6,10,2,8,20,0,1,0,1,0,3,277,45
ils,6,50,30,20,60,6,12,6,6,50,3.4,4393,62
the-thing-la-cosa,0,0,0,0,0,0,0,0,0,0,0,0,0
player-the,0,0,0,0,0,0,0,0,0,0,0,0,0
stardust_memories,6.6,24,17,7,70,0,4,1,3,25,3.8,2789,80
edward_scissorhands,7.6,53,48,5,90,6.8,9,7,2,77,3.8,145994,88
overnight-delivery,4.9,7,3,4,42,0,0,0,0,0,0,0,0
shadrach,5.8,16,8,8,50,5,5,0,5,0,3.6,134,59
antz,7.7,86,82,4,95,7.5,24,23,1,95,2.9,33465,47
impostor,3.9,91,19,72,20,3.6,25,4,21,16,3,1418,46
night_at_the_roxbury,3.4,54,6,48,11,2.6,11,0,11,0,3.1,27913,67
what_dreams_may_come,5.7,66,36,30,54,5.8,16,9,7,56,3.6,31618,85
strangeland,2.3,16,1,15,6,0,2,0,2,0,3.5,4041,65
1001811-battle_of_the_sexes,0,1,1,0,100,0,0,0,0,0,0,0,0
producers_the_movie_musical,5.8,150,76,74,50,5,36,10,26,27,3.1,31343,63
history-of-the-world-part-i1981,5.6,25,15,10,60,0,0,0,0,0,0,0,0
my_cousin_vinny,6.9,38,33,5,86,7,8,6,2,75,0,0,0
nashville,8.6,39,37,2,94,9,5,5,0,100,4.1,3090,84
artists-of-the-20th-century-francis-bacon,0,0,0,0,0,0,0,0,0,0,0,0,0
slam,6.8,21,13,8,61,7.2,8,5,3,62,3.9,549,80
holy_man,3.6,49,6,43,12,3.8,12,1,11,8,2.4,3310,30
one_tough_cop,4.2,20,5,15,25,4,6,1,5,16,2.8,405,28
detroit_9000,5.4,6,1,5,16,0,2,0,2,0,2.9,572,48
mighty_ducks,3.8,25,2,23,8,3.2,5,0,5,0,3.1,14328,64
2010_the_year_we_make_contact,5.7,25,16,9,64,0,2,2,0,100,3.2,5956,58
children_of_a_lesser_god,7.1,24,20,4,83,0,1,1,0,100,3.6,2089,76
1006527-elephant_man,8.2,33,30,3,90,0,4,2,2,50,3.9,16869,90
1057370-beloved,7.1,66,51,15,77,7.3,24,20,4,83,3.3,2521,68
bride_of_chucky,5.3,30,13,17,43,0,4,1,3,25,2.6,20874,52
practical_magic,4.4,54,11,43,20,3.7,15,1,14,6,3.2,24912,73
alarmist,5.6,11,6,5,54,0,1,0,1,0,0,0,0
1084175-happiness,7.9,44,37,7,84,7.8,9,7,2,77,4,11088,88
reach_the_rock,4.5,8,3,5,37,0,1,0,1,0,3.4,22,60
apt_pupil,6,55,29,26,52,5.5,14,7,7,50,3.1,5334,57
pleasantville,7.5,82,70,12,85,6.9,22,16,6,72,3.3,22512,73
1083934-soldier,3.5,50,5,45,10,3.6,15,2,13,13,2.8,5503,46
valkyrie,6,185,113,72,61,6,37,22,15,59,3.5,113378,66
1084398-life_is_beautiful,7.5,84,66,18,78,5.7,16,9,7,56,4.3,65601,96
orgazmo,5.1,32,15,17,46,4.1,7,1,6,14,3.2,9287,66
shattered_image,4.8,14,4,10,28,0,4,0,4,0,0,0,0
tales_from_the_darkside_the_movie,4.5,14,5,9,35,0,3,1,2,33,3.1,2283,49
interview_with_the_vampire,5.8,45,26,19,57,4.6,10,4,6,40,3.7,77706,85
american_history_x,7.2,72,60,12,83,6.6,21,15,6,71,4.2,140060,96
hands_on_a_hard_body,7.1,19,16,3,84,6.8,6,6,0,100,4.1,320,89
living_out_loud,6.3,31,18,13,58,5.8,7,3,4,42,3.4,845,60
belly,3.9,15,2,13,13,0,2,0,2,0,3.9,6432,86
gods_and_monsters,8.4,48,46,2,95,8.5,9,8,1,88,3.7,3109,80
1085113-siege,5.8,59,26,33,44,5,13,4,9,30,3.1,8405,56
waterboy,4.6,72,23,49,31,3.8,17,4,13,23,3.4,79240,74
1084153-elizabeth,7.3,47,38,9,80,8.3,9,9,0,100,3.8,19341,86
velvet_goldmine,6.5,38,21,17,55,5.7,5,1,4,20,3.7,10467,80
i_still_know_what_you_did_last_summer,3.3,53,4,49,7,3.9,11,2,9,18,2.6,19948,42
1088110-ill_be_home_for_christmas,3.9,40,7,33,17,3.5,16,2,14,12,2.6,3438,46
meet_joe_black,5.6,36,18,18,50,5.6,5,2,3,40,3.4,38972,80
dancing_at_lughnasa,6.1,31,20,11,64,6.5,5,2,3,40,3.4,869,59
hard-core-logo,6.4,12,8,4,66,0,4,4,0,100,0,0,0
naked_man,4.9,5,1,4,20,0,0,0,0,0,0,0,0
runaway_train,7.1,27,23,4,85,0,4,3,1,75,3.5,1615,71
desert_bloom,7,9,7,2,77,0,1,0,1,0,0,0,0
stepford_wives,4.7,163,43,120,26,4.9,37,11,26,29,2.6,14476,36
pope_of_greenwich_village,7.4,9,8,1,88,0,1,1,0,100,3.5,970,68
sid_and_nancy,7.3,31,28,3,90,7.4,7,6,1,85,3.5,6365,75
mona_lisa_smile,4.9,147,51,96,34,5.2,41,18,23,43,3.1,23577,61
heart_condition,3.3,7,0,7,0,0,2,0,2,0,2.9,842,43
nights_of_cabiria,8.7,35,34,1,97,8.4,11,11,0,100,4.4,3465,94
big_chill,6.1,31,21,10,67,5.5,6,3,3,50,3.6,4386,79
enemy_of_the_state,6.4,81,57,24,70,6.2,20,13,7,65,3.5,34766,76
rugrats_movie,5.8,47,27,20,57,6.4,11,7,4,63,2.8,6870,42
bugs_life,7.9,80,73,7,91,7.5,18,17,1,94,3.3,64405,61
1084868-celebrity,5.6,37,15,22,40,5.6,5,1,4,20,3,3241,42
central-do-brasil-central-station,7.9,48,45,3,93,8.1,13,12,1,92,4.2,3839,93
savior,6.8,8,5,3,62,0,2,1,1,50,3.7,947,78
waking_ned_devine,7,57,47,10,82,7,13,11,2,84,3.6,4612,85
1094723-celebration,8,36,33,3,91,8.3,5,5,0,100,4.3,5434,95
pink_flamingos,6.6,35,28,7,80,0,4,2,2,50,3.6,4901,74
glen_or_glenda,3.6,22,7,15,31,0,1,0,1,0,2.6,1851,35
gojira,7.6,57,53,4,92,7.5,17,15,2,88,4.1,2309,86
godzilla,4.7,59,15,44,25,5.7,9,3,6,33,2.6,17658,38
king-kong-vs-godzilla,4.4,11,4,7,36,0,1,0,1,0,3.1,2636,49
king_kong,7.7,242,202,40,83,7.6,39,30,9,76,2.8,207337,52
king_kong,7.7,242,202,40,83,7.6,39,30,9,76,2.8,207337,52
king_kong_lives,1.6,9,0,9,0,0,2,0,2,0,2.7,5069,37
desperately_seeking_susan,6.7,23,20,3,86,0,3,3,0,100,2.8,3449,55
emerald_forest,7.2,15,13,2,86,0,0,0,0,0,0,0,0
fletch,6.4,28,21,7,75,0,4,3,1,75,3.3,6895,78
fletch_lives,4.1,13,4,9,30,0,1,0,1,0,2.9,2636,53
1200704-red_sonja,0,0,0,0,0,0,0,0,0,0,0,0,0
1009058-gung_ho,5.3,14,6,8,42,0,1,0,1,0,3,1121,45
money_pit,4.8,19,9,10,47,0,1,0,1,0,3,7189,59
view_to_a_kill,4.8,41,16,25,39,3.6,5,0,5,0,3.1,12502,49
lifeforce,5.4,14,8,6,57,0,0,0,0,0,0,0,0
police_academy,4.6,15,7,8,46,0,0,0,0,0,0,0,0
police_academy_2_their_first_assignment,3.1,13,3,10,23,0,0,0,0,0,0,0,0
police_academy_3_back_in_training,4.2,10,4,6,40,0,1,1,0,100,2.8,6533,49
police_academy_4_citizens_on_patrol,2.4,18,0,18,0,0,3,0,3,0,2.7,6328,46
police_academy_5_assignment_miami_beach,0,2,0,2,0,0,0,0,0,0,0,0,0
police_academy_6_city_under_siege,1.2,7,0,7,0,0,0,0,0,0,0,0,0
babe_pig_in_the_city,6.2,58,35,23,60,5.8,14,8,6,57,2.8,9741,45
home_fries,4.8,35,11,24,31,4.4,6,1,5,16,2.5,4100,34
ringmaster,3,23,5,18,21,0,4,1,3,25,2.1,443,19
very_bad_things,5.6,50,22,28,44,5.1,12,3,9,25,3,5484,57
steam_the_turkish_bath,6.3,16,13,3,81,6.4,5,3,2,60,3.7,781,75
psycho,8.9,67,66,1,98,7.5,8,7,1,87,3.9,32475,90
little_voice,7.2,35,29,6,82,7.3,7,5,2,71,3.4,2979,68
simple_plan,8.1,51,46,5,90,8.2,8,7,1,87,3.4,7546,74
1090089-jack_frost,3.8,47,7,40,14,4,14,3,11,21,2.8,6973,48
star_trek_insurrection,5.8,64,35,29,54,6.7,12,9,3,75,3.1,13225,53
prince_of_egypt,7,82,64,18,78,6.7,25,18,7,72,3.1,16105,67
rushmore,7.8,82,71,11,86,7.4,17,13,4,76,3.7,34168,91
shakespeare_in_love,8.1,101,94,7,93,8,25,23,2,92,3.3,30161,76
mass_appeal,0,2,2,0,100,0,0,0,0,0,0,0,0
1013970-miracle_on_34th_street,8,31,29,2,93,0,2,2,0,100,3.5,5409,81
santa_claus_the_movie,4.1,17,3,14,17,0,1,0,1,0,3.1,2513,66
prancer,6,16,11,5,68,0,3,2,1,66,3,1515,53
pale_rider,7.3,24,22,2,91,0,4,3,1,75,3.6,8286,78
rambo-first-blood-part-ii,4.1,30,9,21,30,0,2,0,2,0,3.1,18865,63
first_blood,7.1,35,30,5,85,6.2,5,4,1,80,3.5,23595,81
rambo_iii,4.6,28,10,18,35,0,4,2,2,50,2.9,16200,51
jewel_of_the_nile,4.9,19,9,10,47,0,1,1,0,100,3,7338,45
romancing_the_stone,7,42,36,6,85,0,4,1,3,25,3.2,14494,62
cocoon,6.1,23,18,5,78,0,4,3,1,75,3.1,7543,55
cocoon_2_the_return,4.6,10,3,7,30,0,1,0,1,0,2.7,2029,37
rocky_ii,6.4,23,16,7,69,0,3,2,1,66,3.4,51625,79
rocky_iii,5.4,29,18,11,62,0,2,1,1,50,3.3,48532,74
rocky_iv,4.7,34,15,19,44,0,4,0,4,0,3.4,53876,79
rocky_v,4,29,7,22,24,3.9,5,2,3,40,2.8,34216,53
clue,6.2,19,14,5,73,0,2,0,2,0,3.6,16850,85
young_sherlock_holmes,5.6,19,12,7,63,0,1,1,0,100,3.3,2485,63
violets_are_blue,5.3,7,4,3,57,0,1,1,0,100,3.4,93,39
back-to-school,6.8,24,21,3,87,0,3,3,0,100,2.9,3814,60
heartburn,5.7,11,7,4,63,0,1,0,1,0,3.2,1466,52
nothing_in_common,5.8,18,10,8,55,0,1,0,1,0,2.8,1198,38
extremities,5.9,7,4,3,57,0,0,0,0,0,0,0,0
karate_kid,6.9,41,37,4,90,6.9,5,4,1,80,3.3,20688,71
karate_kid_part_2,4.8,20,8,12,40,0,0,0,0,0,0,0,0
karate_kid_part_iii,4.1,17,4,13,23,0,2,0,2,0,2.8,9109,46
national_lampoons_christmas_vacation,6.2,34,21,13,61,6,5,2,3,40,3.5,21650,83
youve_got_mail,6.2,75,51,24,68,6.4,20,15,5,75,3.1,60706,70
1008166-general,8.9,38,35,3,92,0,4,2,2,50,4.4,3785,93
theory_of_flight,5.6,19,10,9,52,5.1,5,1,4,20,3.5,345,63
1084146-thin_red_line,7.1,80,63,17,78,7.5,22,21,1,95,3.4,27248,75
faculty,5.6,37,19,18,51,0,3,0,3,0,2.9,14071,55
1084582-mighty_joe_young,5.8,42,22,20,52,7.2,5,4,1,80,2.8,10755,48
1084582-mighty_joe_young,5.8,42,22,20,52,7.2,5,4,1,80,2.8,10755,48
patch_adams,4,55,13,42,23,3.8,16,4,12,25,3.3,20869,77
stepmom,5.1,53,23,30,43,5.3,17,8,9,47,3.3,22696,75
civil_action,6.4,66,40,26,60,5.8,13,7,6,53,3.1,3573,53
down_in_the_delta,6.8,22,17,5,77,7.4,6,5,1,83,3.6,434,68
hurlyburly,5.9,34,20,14,58,5.2,6,2,4,33,3.2,1455,56
tea_with_mussolini,6.4,33,22,11,66,6.3,6,3,3,50,3.5,1769,72
affliction,7.6,44,38,6,86,8.8,7,7,0,100,3.4,1078,69
1084699-another_day_in_paradise,5.7,46,26,20,56,6.1,12,7,5,58,3.2,1703,57
hilo_country,5.4,34,19,15,55,4.9,15,6,9,40,3.1,620,43
hilary_and_jackie,7.5,43,38,5,88,7.9,13,12,1,92,3.7,1702,81
playing_by_heart,6,51,32,19,62,6,12,6,6,50,3.6,5334,76
twentyfourseven,5.7,20,7,13,35,5.6,5,1,4,20,3.9,451,84
1084607-at_first_sight,5.2,36,12,24,33,5.4,6,1,5,16,2.9,2599,48
requiem_for_a_dream,7.4,127,99,28,77,6.6,32,21,11,65,4.1,103666,93
varsity_blues,5,51,20,31,39,5,13,5,8,38,3.2,17053,75
1085867-virus,3.2,44,4,40,9,2.8,13,1,12,7,2.4,2719,26
garbage_pail_kids_movie,1.9,11,0,11,0,0,1,0,1,0,2.6,1589,37
howard_the_duck,2.5,32,5,27,15,0,3,0,3,0,2.6,7309,43
ninth_gate,4.9,85,35,50,41,4,24,6,18,25,3.2,23993,60
gate_2_return_to_the_nightmare,0,0,0,0,0,0,0,0,0,0,0,0,0
boy_who_could_fly,5.9,16,11,5,68,0,1,1,0,100,3.2,1754,63
1007602-fly,8,44,40,4,90,0,3,1,2,33,3.3,14099,74
1007602-fly,8,44,40,4,90,0,3,1,2,33,3.3,14099,74
fly_ii,4.4,15,4,11,26,0,0,0,0,0,0,0,0
10004288-running_scared,4.5,128,51,77,39,4.4,31,10,21,32,3.6,35992,77
1001180-armed_and_dangerous,3,7,1,6,14,0,0,0,0,0,0,0,0
texas_chainsaw_massacre,4.8,152,55,97,36,4.2,33,6,27,18,3.2,36030,67
texas_chainsaw_massacre_2,4.6,21,9,12,42,0,2,0,2,0,2.9,8495,51
leatherface_the_texas_chainsaw_massacre_3,3.4,14,2,12,14,0,1,0,1,0,2.9,6411,52
texas_chainsaw_massacre_the_next_generation,3.2,28,4,24,14,0,4,0,4,0,2.4,5539,34
ruthless_people,6.7,21,19,2,90,0,1,1,0,100,3.1,3852,62
trick_r_treat,7.5,20,17,3,85,0,1,1,0,100,3.5,15410,67
deadly_friend,3.7,6,0,6,0,0,0,0,0,0,0,0,0
belizaire_the_cajun,6.2,6,4,2,66,0,1,1,0,100,3.6,147,63
name_of_the_rose,6.2,18,13,5,72,0,1,0,1,0,3.6,8830,83
jumpin_jack_flash,3.9,18,5,13,27,0,1,0,1,0,2.8,4253,55
peggy_sue_got_married,6.8,24,21,3,87,6.8,7,5,2,71,2.9,5428,47
crocodile_dundee,6.6,26,23,3,88,0,2,1,1,50,3,11828,55
crocodile_dundee_2,3.6,21,3,18,14,0,0,0,0,0,0,0,0
tough_guys_dont_dance,4.9,18,7,11,38,0,4,2,2,50,3.3,251,49
soul_man,3,22,3,19,13,0,4,1,3,25,2.6,1023,37
color_of_money,7.3,34,31,3,91,6.8,8,6,2,75,3.3,8226,65
52_pickup,5.8,10,5,5,50,0,1,1,0,100,3.1,248,48
heartbreak_ridge,6.7,13,11,2,84,0,1,1,0,100,3.5,4368,73
firewalker,3,10,0,10,0,0,4,0,4,0,2.8,1109,41
1021312-three_amigos,5.2,17,9,8,52,0,1,0,1,0,3.1,12978,65
1085275-gloria,4.1,27,5,22,18,5.1,6,1,5,16,2.7,660,31
dry_cleaning,6.6,15,12,3,80,0,2,2,0,100,3.1,198,46
my_name_is_joe,7.3,23,20,3,86,8.1,5,5,0,100,3.8,1146,81
still_crazy,6.5,25,18,7,72,7,6,4,2,66,3.8,1495,81
el-dia-de-la-bestia-the-day-of-the-beast,6.7,9,7,2,77,0,0,0,0,0,0,0,0
shes_all_that,4.9,55,21,34,38,4.8,12,3,9,25,3,53730,60
24_hour_woman,5.8,14,8,6,57,0,4,3,1,75,3.4,50,50
blood_guts_bullets_and_octane,5.4,22,10,12,45,0,3,0,3,0,2.9,645,40
peeping-tom,8.2,31,29,2,93,7.2,7,5,2,71,4,3195,85
1087648-payback,5.8,70,36,34,51,5,19,8,11,42,3.2,12940,67
simply_irresistible,4,29,4,25,13,4.9,5,1,4,20,2.9,6203,55
20_dates,4.8,31,12,19,38,3.1,10,0,10,0,0,0,0
the-harmonists,7,35,28,7,80,7.3,11,9,2,81,3.8,302,84
last_days,5.9,111,64,47,57,6,35,23,12,65,3.1,5692,53
la-planete-sauvage-the-savage-planet-the-fantastic-planet-planet-of-incredible-creatures,7.1,22,19,3,86,0,2,1,1,50,4,2423,86
blast_from_the_past,6.1,35,21,14,60,6.7,5,4,1,80,2.9,12330,54
message_in_a_bottle,5.2,35,11,24,31,6,5,3,2,60,3.2,17649,67
god_said_ha,6.9,21,18,3,85,7.6,5,5,0,100,3.4,398,67
jawbreaker,3.3,57,4,53,7,3,19,0,19,0,2.8,8386,54
october_sky,7.6,70,63,7,90,7.2,14,12,2,85,3.6,12678,84
office_space,6.8,88,70,18,79,6.4,24,17,7,70,4,78802,92
the-apple-sib,7,20,16,4,80,8.2,5,5,0,100,3.7,409,77
200_cigarettes,4.5,57,17,40,29,3.9,19,5,14,26,3,5146,54
8mm,4.2,78,17,61,21,3.1,21,2,19,9,3,14973,56
other_sister,4.7,48,14,34,29,4.6,13,4,9,30,3.3,8954,68
breakfast_of_champions,4.2,44,11,33,25,3.4,13,1,12,7,2.5,1509,31
break_up,5,187,62,125,33,4.5,40,8,32,20,3.1,107481,52
eight_days_a_week,3.8,9,2,7,22,0,0,0,0,0,0,0,0
just_the_ticket,4.5,10,2,8,20,0,3,0,3,0,3,410,41
ballad_of_narayama,8.2,9,9,0,100,0,1,1,0,100,4.3,634,91
pet_sematary,5.2,18,9,9,50,0,0,0,0,0,0,0,0
pet_sematary_ii,4,16,5,11,31,0,0,0,0,0,0,0,0
children_of_the_corn_ii_the_final_sacrifice,2.3,8,2,6,25,0,1,0,1,0,2.8,2650,39
children_of_the_corn_iii_urban_harvest,0,1,0,1,0,0,0,0,0,0,0,0,0
christine,5.7,21,14,7,66,0,4,1,3,25,3.2,10394,63
night_shift,6.4,19,17,2,89,0,2,1,1,50,3.2,1720,55
1093881-house_on_haunted_hill,4.4,53,13,40,24,3.5,11,2,9,18,2.9,13288,49
airport,5.9,13,9,4,69,0,1,0,1,0,3.1,2253,48
airport_1975,4.8,12,4,8,33,0,1,0,1,0,2.9,1688,36
id-1977,0,0,0,0,0,0,0,0,0,0,0,0,0
1017815-rollercoaster,6,6,3,3,50,0,0,0,0,0,0,0,0
towering_inferno,6.4,19,15,4,78,0,1,1,0,100,3.3,4474,67
albino_alligator,5.5,17,8,9,47,5.4,6,2,4,33,3,1198,42
1013772-meteor,3.6,11,1,10,9,0,0,0,0,0,0,0,0
westworld,7.1,30,27,3,90,0,3,3,0,100,3.5,4334,68
logans_run,6.2,27,19,8,70,0,3,2,1,66,3.3,9250,65
1016397-planet_of_the_apes,7.4,44,39,5,88,5.5,5,3,2,60,3.4,12844,80
beneath_the_planet_of_the_apes,5.3,22,9,13,40,0,1,0,1,0,3,4261,46
battle_for_the_planet_of_the_apes,4.7,24,9,15,37,0,2,0,2,0,2.9,3262,38
conquest_of_the_planet_of_the_apes,5.5,18,8,10,44,0,2,1,1,50,3,3697,49
escape_from_the_planet_of_the_apes,5.7,23,18,5,78,0,2,2,0,100,3,3852,49
avalanche_alley,0,0,0,0,0,0,0,0,0,0,0,0,0
105,0,0,0,0,0,0,0,0,0,0,0,0,0
concorde_airport_79,4.3,5,1,4,20,0,2,1,1,50,2.5,369,23
beyond_the_poseidon_adventure,0,2,0,2,0,0,1,0,1,0,2.7,1212,33
dancemaker,7.9,10,9,1,90,0,2,2,0,100,0,0,0
analyze_this,6.4,101,69,32,68,6,22,14,8,63,3.1,15881,57
corruptor,5.3,46,22,24,47,5.7,15,8,7,53,3,2255,43
cruel_intentions,5.3,76,36,40,47,4.7,24,9,15,37,3.4,56824,79
six-ways-to-sunday,4.8,10,4,6,40,0,1,0,1,0,3.3,459,58
school_of_flesh,6.1,18,13,5,72,0,4,4,0,100,3.5,272,59
relax_its_just_sex,5.9,16,8,8,50,0,3,2,1,66,3.4,732,64
deep_end_of_the_ocean,5.8,33,14,19,42,5.2,7,1,6,14,3.2,2998,62
a-fit-of-rage,0,0,0,0,0,0,0,0,0,0,0,0,0
wing_commander,2.8,46,5,41,10,2.2,11,0,11,0,2.2,2768,26
1090789-haunting,3.7,87,15,72,17,3.1,24,3,21,12,2.7,10812,42
dead_ringers,7.7,35,29,6,82,5.7,6,3,3,50,3.6,4690,80
my_boyfriends_back,3.4,10,1,9,10,0,2,0,2,0,2.7,1035,43
1061401-village_of_the_damned,4,30,9,21,30,4.2,5,2,3,40,2.7,4194,36
children_of_the_damned,5.6,12,9,3,75,0,0,0,0,0,0,0,0
baby_geniuses,1.9,43,1,42,2,2.1,10,0,10,0,2.5,8215,32
telling_you,5.6,5,1,4,20,0,0,0,0,0,0,0,0
i_stand_alone,7.7,20,17,3,85,0,2,2,0,100,3.9,1587,82
forces_of_nature,5.3,63,29,34,46,4.7,18,6,12,33,2.6,7489,37
1011605-king_and_i,8.2,19,19,0,100,0,1,1,0,100,3.6,12939,79
ravenous,5.5,36,14,22,38,5.2,6,2,4,33,3.6,4588,78
1084928-true_crime,6,38,20,18,52,6.8,6,5,1,83,3.2,2873,51
bandits,6.1,136,86,50,63,5.9,34,20,14,58,3.1,9238,56
dangerous_beauty,6.4,26,18,8,69,6.8,7,5,2,71,4.1,2764,87
1011605-king_and_i,8.2,19,19,0,100,0,1,1,0,100,3.6,12939,79
dougs-first-movie,4.6,32,8,24,25,4.4,9,3,6,33,2.9,1446,43
edtv,6.3,42,26,16,61,6.2,7,3,4,42,2.6,8130,31
mod_squad,3,51,2,49,3,3.4,13,1,12,7,2.4,1890,21
among_giants,5.5,19,11,8,57,0,4,2,2,50,3.2,111,33
walk_on_the_moon,6.7,35,25,10,71,6.6,6,4,2,66,3.4,2848,67
matrix,7.4,125,108,17,86,6.2,28,19,9,67,3.6,207333,81
1084081-tango,6.8,20,14,6,70,8.5,5,4,1,80,3.9,767,82
1087047-outoftowners,5,34,8,26,23,4.9,5,1,4,20,2.6,2186,33
dreamlife_of_angels,7.6,42,39,3,92,8,13,13,0,100,3.9,1181,83
love_etc,0,4,2,2,50,0,1,1,0,100,3.2,217,54
metroland,6.4,27,17,10,62,0,4,3,1,75,3.3,1014,55
sticky_fingers_of_time,6.2,5,4,1,80,0,2,2,0,100,3,247,48
following,7.1,21,16,5,76,0,3,1,2,33,3.8,7121,85
1087053-go,7.6,72,66,6,91,7,19,15,4,78,3.2,8608,72
never_been_kissed,5.7,79,44,35,55,5.4,25,12,13,48,3.3,53088,70
twin-dragons,5.1,37,16,21,43,4.5,7,3,4,42,3.1,3144,55
cookies_fortune,7.5,55,47,8,85,7.4,12,11,1,91,3.2,1364,57
foolish-wives,9,7,7,0,100,0,0,0,0,0,0,0,0
lovers_of_the_arctic_circle,7,23,19,4,82,0,4,4,0,100,4.3,3613,92
goodbye_lover,4.7,33,10,23,30,3.6,10,1,9,10,2.9,457,35
waking_life,7.4,137,109,28,79,7.6,32,26,6,81,4,17715,87
lovers-and-friends,0,0,0,0,0,0,0,0,0,0,0,0,0
hideous_kinky,5.9,34,21,13,61,0,4,3,1,75,3.3,2069,56
jeanne-and-the-perfect-guy,5.8,5,3,2,60,0,2,2,0,100,3.3,323,55
1074910-monster,5.8,10,4,6,40,0,1,0,1,0,3.8,1005,78
open-your-eyes,7.4,45,38,7,84,6.9,8,6,2,75,3.9,11790,85
slc_punk,5.6,31,19,12,61,6.2,5,3,2,60,3.8,9837,89
1087050-lost_and_found,3.6,52,7,45,13,2.8,18,0,18,0,2.5,1416,30
pushing_tin,5.6,65,32,33,49,5.5,16,8,8,50,2.9,5381,43
election,7.8,101,93,8,92,7.7,23,21,2,91,3.3,11134,72
existenz,6.7,62,44,18,70,5.7,10,5,5,50,3.2,10592,65
little_bit_of_soul,0,4,2,2,50,0,0,0,0,0,0,0,0
the-mighty-peking-man,0,0,0,0,0,0,0,0,0,0,0,0,0
revolutionary_road,6.7,194,133,61,68,6.9,36,25,11,69,3.5,46044,70
let_it_come_down_the_life_of_paul_bowles,0,3,3,0,100,0,2,2,0,100,3,172,45
entrapment,5.2,80,30,50,37,4.7,18,7,11,38,3,17343,57
idle_hands,3.4,53,8,45,15,3,17,1,16,5,2.9,8232,57
get_real,6.4,45,35,10,77,6.4,13,10,3,76,3.8,2164,79
the-king-of-masks,7.4,18,16,2,88,7.7,5,5,0,100,4.1,775,88
three_seasons_1999,6.7,30,24,6,80,0,4,4,0,100,0,0,0
1087341-winslow_boy,7.9,35,34,1,97,8.2,6,6,0,100,3.6,768,70
mildred_pierce,7.6,30,26,4,86,0,2,2,0,100,4.1,2165,90
night_of_the_comet,6.5,20,17,3,85,0,2,2,0,100,3.3,2733,57
chopping_mall,4.4,5,2,3,40,0,0,0,0,0,0,0,0
my_science_project,3.2,5,1,4,20,0,0,0,0,0,0,0,0
1029314-dick_tracy,5.7,43,28,15,65,4.6,8,3,5,37,2.8,10803,44
1087270-mummy,5.7,81,44,37,54,5.1,17,7,10,41,3.4,79634,75
the-castle,6.9,33,29,4,87,6.6,6,5,1,83,4.1,3419,91
1013470-mascara,0,0,0,0,0,0,0,0,0,0,0,0,0
this_is_my_father,6.7,27,20,7,74,6,5,4,1,80,3.9,442,79
xiu_xiu_the_sent_down_girl,8,24,23,1,95,9,5,5,0,100,3.8,593,81
tales-of-the-night-fairies,0,0,0,0,0,0,0,0,0,0,0,0,0
trippin,4.2,12,1,11,8,0,4,0,4,0,3.8,73,62
after_life,6.9,22,18,4,81,0,4,4,0,100,4.1,1840,90
black_mask,4.9,28,14,14,50,0,1,0,1,0,0,0,0
edge-of-seventeen2000,0,0,0,0,0,0,0,0,0,0,0,0,0
the-endurance,7.7,65,62,3,95,7.9,24,24,0,100,3.8,415,79
star-warpd,0,0,0,0,0,0,0,0,0,0,0,0,0
phantom_love,0,0,0,0,0,0,0,0,0,0,0,0,0
besieged,7,46,34,12,73,6.7,12,7,5,58,3.7,762,80
frogs_for_snakes,4.4,10,3,7,30,0,2,0,2,0,3.4,141,50
the-saragossa-manuscript,7.3,10,9,1,90,0,2,2,0,100,4.2,509,90
1087270-mummy,5.7,81,44,37,54,5.1,17,7,10,41,3.4,79634,75
1087270-mummy,5.7,81,44,37,54,5.1,17,7,10,41,3.4,79634,75
mummys_curse,6.2,7,4,3,57,0,0,0,0,0,0,0,0
mummys_ghost,0,4,2,2,50,0,0,0,0,0,0,0,0
mummys_hand,6.1,7,5,2,71,0,0,0,0,0,0,0,0
mummy_tomb_of_the_dragon_emperor,3.7,161,21,140,13,3.7,32,3,29,9,3,79989,40
mommie_dearest,5.6,30,17,13,56,4.8,5,2,3,40,3.6,3417,78
superman_the_movie,8,52,49,3,94,7.4,6,5,1,83,3.5,39510,77
superman_ii,7.4,41,36,5,87,8.4,5,5,0,100,3.2,30072,66
superman_iii,4.4,40,9,31,22,0,3,0,3,0,2.7,17727,39
superman_iv_the_quest_for_peace,2.8,30,3,27,10,3.2,5,1,4,20,2.5,13076,30
1006234-dracula,7.7,42,39,3,92,7.7,6,6,0,100,3.6,8598,76
house_of_dracula,5.7,7,4,3,57,0,1,0,1,0,3.1,1009,41
1007818-frankenstein,8.5,38,38,0,100,7.8,5,5,0,100,3.6,7211,81
son_of_frankenstein,7.3,18,17,1,94,0,2,2,0,100,0,0,0
ghost_of_frankenstein,6.3,8,7,1,87,0,0,0,0,0,0,0,0
frankenstein_meets_the_wolf_man,5.2,10,3,7,30,0,0,0,0,0,0,0,0
curse_of_frankenstein,7.6,7,7,0,100,0,0,0,0,0,0,0,0
wolf_man,7.7,31,29,2,93,0,3,2,1,66,3.7,2541,77
howling_ii,3.1,6,1,5,16,0,1,0,1,0,2.5,1403,27
tarantula,6.3,11,10,1,90,0,0,0,0,0,0,0,0
rocky_horror_picture_show,6.5,35,27,8,77,0,3,0,3,0,3.6,49873,85
it_came_from_hollywood,0,0,0,0,0,0,0,0,0,0,0,0,0
1021242-thing,7.7,26,23,3,88,0,2,1,1,50,3.6,2130,71
it-came-from-outer-space,6.8,26,21,5,80,0,3,2,1,66,3.1,796,51
war_of_the_worlds,7,244,178,66,72,6.7,42,28,14,66,2.9,162092,45
it_came_from_beneath_the_sea,6,7,5,2,71,0,0,0,0,0,0,0,0
1010678-invasion_of_the_body_snatchers,8.9,36,36,0,100,0,2,2,0,100,3.6,3820,81
earth_vs_the_flying_saucers,5.7,13,9,4,69,0,0,0,0,0,0,0,0
it_conquered_the_world,5.6,5,4,1,80,0,0,0,0,0,0,0,0
mole_people,0,4,1,3,25,0,0,0,0,0,0,0,0
swamp_thing,5.8,26,18,8,69,0,3,1,2,33,2.7,3423,34
pork_chop_hill,0,4,4,0,100,0,0,0,0,0,0,0,0
run_silent_run_deep,7,7,7,0,100,0,0,0,0,0,0,0,0
notting_hill,7.1,97,80,17,82,6.8,28,21,7,75,3.3,85951,74
1089671-13th_floor,4.5,61,17,44,27,3.8,18,3,15,16,3,5631,61
eternity_and_a_day,7.2,21,20,1,95,7.2,6,5,1,83,4.3,1029,91
loss_of_sexual_innocence,4.8,29,13,16,44,7,5,4,1,80,3.3,449,60
twice_upon_a_yesterday,4.8,21,6,15,28,0,3,1,2,33,3.3,477,55
instinct,4.3,66,18,48,27,3.7,15,3,12,20,3.2,4403,67
1087935-buena_vista_social_club,7.5,41,37,4,90,8.2,7,6,1,85,4,2963,88
desert_blue,5.1,18,7,11,38,0,4,1,3,25,3.2,414,49
finding-north,4.7,9,4,5,44,0,1,0,1,0,2.9,277,33
1087937-limbo,7,39,28,11,71,6.9,6,3,3,50,3.5,169,75
austin_powers_the_spy_who_shagged_me,6,85,44,41,51,5.6,20,11,9,55,3.3,70870,73
red_violin,7.1,39,28,11,71,7.4,6,5,1,83,3.9,7025,91
tarzan,7.6,101,89,12,88,7.3,27,23,4,85,3.2,30231,63
generals_daughter,4.3,87,19,68,21,3.5,23,3,20,13,3,6034,55
get_smarts_bruce_and_loyd_out_of_control,0,2,1,1,50,0,0,0,0,0,0,0,0
1091577-ideal_husband,7.4,63,54,9,85,7.4,15,14,1,93,3.4,2877,66
legend_of_1900,6.2,35,19,16,54,6,5,2,3,40,4.2,5983,92
run_lola_run,7.7,78,72,6,92,7.5,20,19,1,95,3.8,33702,88
trekkies,7.3,41,35,6,85,6.9,6,4,2,66,3.4,1371,67
daddy-who,0,0,0,0,0,0,0,0,0,0,0,0,0
lost_boys,6.3,40,30,10,75,0,4,2,2,50,3.7,48695,85
dinner_game,6.8,44,32,12,72,7.7,11,10,1,90,4.1,5214,90
my_son_the_fanatic,6.9,27,21,6,77,7.4,6,4,2,66,3.5,322,73
arachnophobia,6.6,26,22,4,84,0,2,2,0,100,2.8,10804,43
south_park_bigger_longer_and_uncut,7,92,74,18,80,6.7,24,20,4,83,3.7,46689,86
wild_wild_west,3.9,102,21,81,20,3.7,24,4,20,16,2.7,31689,39
son-of-sam,0,0,0,0,0,0,0,0,0,0,0,0,0
broken_vessels,5.7,14,9,5,64,0,3,2,1,66,0,0,0
lovers_on_the_bridge,7.1,14,11,3,78,0,2,2,0,100,4,1699,86
late_august_early_september,6.7,22,18,4,81,7.6,7,7,0,100,3.5,332,61
american_pie,5.7,115,67,48,58,5.5,25,13,12,52,3.4,203348,63
arlington_road,6.1,86,52,34,60,5.7,19,9,10,47,3.3,6430,72
autumn_tale,7.8,32,30,2,93,8.3,11,11,0,100,3.8,273,81
muppets_from_space,6.2,53,33,20,62,5.6,20,10,10,50,3,4740,55
blair_witch_project,7.5,125,106,19,84,7.2,28,25,3,89,2.5,23900,47
my_life_so_far,6.3,25,18,7,72,6.2,5,3,2,60,3.1,618,41
eyes_wide_shut,7.3,119,93,26,78,6.7,26,18,8,69,2.9,26285,66
lake_placid,5,68,26,42,38,4,17,4,13,23,2.6,12183,40
wood,6,56,34,22,60,5.7,17,10,7,58,3.9,6421,90
velocity_of_gary,4.1,17,4,13,23,0,1,0,1,0,3.1,516,49
ghostbusters,7.6,46,43,3,93,6.2,5,3,2,60,3.6,65639,81
ghostbusters_2,5.2,34,18,16,52,5.4,5,3,2,60,3.2,30085,62
1090789-haunting,3.7,87,15,72,17,3.1,24,3,21,12,2.7,10812,42
inspector_gadget,4,61,13,48,21,3.9,21,4,17,19,2.3,11127,26
trick,6.8,22,17,5,77,6.8,6,4,2,66,3.7,1364,80
1090759-deep_blue_sea,5.7,89,51,38,57,5.8,22,14,8,63,2.8,26286,44
mystery_men,5.7,100,60,40,60,5.7,28,17,11,60,2.8,14333,52
runaway_bride,5.3,82,37,45,45,4.8,27,10,17,37,3,48629,57
twin_falls_idaho,7.3,44,34,10,77,7.6,7,6,1,85,3.8,751,82
killing,8.3,26,25,1,96,0,3,3,0,100,4,5595,90
killers_kiss,6.8,17,14,3,82,0,3,3,0,100,3.3,2112,56
1019544-spartacus,8.1,45,43,2,95,0,4,3,1,75,3.7,25019,79
1012611-lolita,8,38,37,1,97,0,2,2,0,100,3.7,11593,80
barry_lyndon,7.8,49,46,3,93,7.5,7,7,0,100,4.1,12262,90
400_blows,9.3,48,48,0,100,8.8,8,8,0,100,4.4,9787,95
jules_and_jim,8.9,31,30,1,96,0,4,4,0,100,4.2,6006,89
vibes,2.8,7,0,7,0,0,1,0,1,0,3.3,404,59
mosquito_coast,6.4,20,15,5,75,0,1,0,1,0,3.2,3391,55
golden_child,3.9,19,5,14,26,0,2,1,1,50,2.9,9053,49
brighton_beach_memoirs,5.7,9,6,3,66,0,1,0,1,0,3.4,596,69
assassination_of_jesse_james_by_the_coward_robert_ford,7.1,162,121,41,74,6.6,36,22,14,61,3.7,57534,73
crimes_of_the_heart,7.6,14,14,0,100,0,1,1,0,100,3.3,602,53
color_purple,6.7,24,21,3,87,0,1,1,0,100,3.9,30970,93
1015199-no_mercy,3.4,13,2,11,15,4.4,5,2,3,40,2.8,740,32
menage,0,4,3,1,75,0,1,1,0,100,3.8,345,75
1014759-native_son,6,9,5,4,55,0,4,1,3,25,3.4,71,61
1014027-mission,6.4,16,11,5,68,0,2,1,1,50,3.8,11307,83
1012514-little_shop_of_horrors,6.2,11,10,1,90,0,0,0,0,0,0,0,0
1012514-little_shop_of_horrors,6.2,11,10,1,90,0,0,0,0,0,0,0,0
allan_quatermain_and_the_lost_city_of_gold,0,3,2,1,66,0,0,0,0,0,0,0,0
morning_after,5.8,15,11,4,73,0,1,1,0,100,2.9,557,33
radio_days,7.9,21,20,1,95,0,1,1,0,100,3.8,3253,82
from_the_hip,4.7,6,1,5,16,0,1,0,1,0,3.2,411,59
outrageous_fortune,5,20,10,10,50,5,5,2,3,40,3,1206,54
bedroom_window,6,14,12,2,85,0,0,0,0,0,0,0,0
deadtime_stories,0,3,0,3,0,0,0,0,0,0,0,0,0
light_of_day,5.2,12,7,5,58,0,1,1,0,100,3.1,311,41
1023087-wanted_dead_or_alive,4.1,8,2,6,25,0,1,0,1,0,2.9,934,43
frances,7.6,15,14,1,93,0,1,1,0,100,3.8,713,78
plenty,7.3,7,5,2,71,0,1,1,0,100,3.4,613,54
1090805-dick,6.3,70,49,21,70,6.6,26,19,7,73,2.7,3840,45
iron_giant,8,111,108,3,97,7.7,31,30,1,96,3.3,17836,72
sixth_sense,7.4,126,107,19,84,6.8,28,22,6,78,3.8,100968,87
thomas_crown_affair_the,6.4,88,59,29,67,6.6,25,18,7,72,3.3,15699,71
thomas_crown_affair_the,6.4,88,59,29,67,6.6,25,18,7,72,3.3,15699,71
acid_house,5.8,19,9,10,47,0,2,1,1,50,3.5,2715,68
adventures_of_sebastian_cole,5.7,22,9,13,40,6.6,5,4,1,80,0,0,0
illuminata,5.6,23,9,14,39,5.5,7,3,4,42,3.4,320,64
stiff-upper-lips,4.8,7,2,5,28,0,0,0,0,0,0,0,0
whole_ten_yards,2.8,116,5,111,4,3.3,31,2,29,6,3,11437,51
bowfinger,7.1,107,85,22,79,7.3,26,23,3,88,2.8,8721,49
brokedown_palace,4.7,34,10,24,29,6,5,3,2,60,3.2,4980,66
detroit_rock_city,5.4,36,17,19,47,4.6,5,1,4,20,3.5,9815,80
alice-et-martin-alice-and-martin,6.3,42,26,16,61,6.6,13,10,3,76,3.4,246,51
better_than_chocolate,5.8,21,8,13,38,0,4,1,3,25,3.8,3884,78
punk-drunk-love-the-images-of-mick-rock,0,0,0,0,0,0,0,0,0,0,0,0,0
marcello-mastroianni-i-remember,7.8,7,7,0,100,0,1,1,0,100,3,175,48
1004407-cobra,2.5,14,1,13,7,0,3,1,2,33,2.7,5821,43
never_talk_to_strangers,3.6,20,3,17,15,5,5,2,3,40,2.8,1191,41
1009426-heaven_can_wait,7.8,9,8,1,88,0,0,0,0,0,0,0,0
1017222-raven,6.4,9,8,1,88,0,0,0,0,0,0,0,0
tingler,5.9,14,10,4,71,0,0,0,0,0,0,0,0
1016369-pit_and_the_pendulum,6.4,14,11,3,78,0,0,0,0,0,0,0,0
tomb_of_ligeia,6.4,6,5,1,83,0,0,0,0,0,0,0,0
1013485-masque_of_the_red_death,5.9,12,7,5,58,0,0,0,0,0,0,0,0
1021067-terror,6.1,10,6,4,60,0,0,0,0,0,0,0,0
haunted_honeymoon,3.5,8,2,6,25,0,0,0,0,0,0,0,0
cats_eye,5.5,23,15,8,65,0,3,2,1,66,3.1,5931,52
and_now_for_something_completely_different,6.9,19,17,2,89,0,2,1,1,50,3.8,16003,85
damien_1978,0,0,0,0,0,0,0,0,0,0,0,0,0
airplane,8.3,49,48,1,97,7.8,5,5,0,100,3.6,31137,85
airplane_2_the_sequel,5.2,18,7,11,38,0,1,0,1,0,2.9,10524,52
american_werewolf_in_paris,3.7,25,2,23,8,4.5,6,1,5,16,2.8,10235,38
national_lampoons_european_vacation,4.8,20,8,12,40,0,0,0,0,0,0,0,0
national_lampoons_vacation,7.3,34,32,2,94,0,3,3,0,100,3.5,11330,80
1007990-funny_farm,5.2,17,11,6,64,0,1,1,0,100,2.9,2927,51
big,7.9,52,50,2,96,6.8,5,4,1,80,3.4,33658,73
problem_child_2,2.6,12,2,10,16,0,1,0,1,0,0,0,0
problem_child_2,2.6,12,2,10,16,0,1,0,1,0,0,0,0
little_nemo_adventures_in_slumberland,0,0,0,0,0,0,0,0,0,0,0,0,0
oscar_and_lucinda,6.6,31,20,11,64,7.8,7,6,1,85,0,0,0
tequila_sunrise,5.1,18,9,9,50,0,3,0,3,0,2.9,3959,44
pelican_brief,5.5,47,25,22,53,5.5,7,3,4,42,3.2,12632,62
1004151-christmas_story,8.3,43,38,5,88,0,3,2,1,66,3.7,23109,82
mickey_blue_eyes,5.4,72,32,40,44,5.1,22,8,14,36,2.7,6320,39
teaching_mrs_tingle,4,68,13,55,19,4,24,5,19,20,2.5,4339,34
universal_soldier,4.2,23,5,18,21,4.3,7,2,5,28,2.8,9415,48
love_stinks,3.5,47,9,38,19,3.8,16,3,13,18,3.2,1225,66
perfect-blue,6.4,22,14,8,63,0,2,1,1,50,3.9,4350,86
1093923-with_friends_like_these,5.4,14,7,7,50,4.7,5,2,3,40,2.6,46,33
1092437-in_too_deep,4.9,55,20,35,36,5.8,20,10,10,50,3.6,1315,76
jack-kerouac-king-of-the-beats,0,0,0,0,0,0,0,0,0,0,0,0,0
vampire_bat,0,4,2,2,50,0,0,0,0,0,0,0,0
iron_eagle,3.6,5,2,3,40,0,0,0,0,0,0,0,0
iron_eagle_2,0,1,0,1,0,0,0,0,0,0,0,0,0
iron_eagle_3_aces,2.2,6,0,6,0,0,1,0,1,0,2.5,1084,27
iron_eagle_4,0,0,0,0,0,0,0,0,0,0,0,0,0
three_days_of_the_condor,7,37,32,5,86,0,4,2,2,50,3.8,3200,83
1075422-hamlet,8.2,54,51,3,94,7.2,14,11,3,78,3.8,5816,86
male-or-female2004,0,0,0,0,0,0,0,0,0,0,0,0,0
1038176-medicine_man,3.9,18,4,14,22,0,2,0,2,0,2.9,3697,51
spiders_part_1_the_the_golden_lake,0,3,3,0,100,0,0,0,0,0,0,0,0
on_the_ropes,7.6,13,12,1,92,0,3,3,0,100,3.3,155,63
ring_around_the_rosie,0,3,0,3,0,0,0,0,0,0,0,0,0
13th_warrior,4.6,86,28,58,32,4.9,18,7,11,38,3.2,24204,66
astronauts_wife,4.2,57,9,48,15,4.6,18,5,13,27,2.8,11206,42
muse,5.9,76,39,37,51,5.6,23,10,13,43,2.6,1169,29
cabaret_balkan,7.8,13,11,2,84,0,4,4,0,100,3.8,311,78
1094164-dog_of_flanders,4.5,23,4,19,17,0,3,0,3,0,3.7,259,76
1106080-lost_son,0,3,2,1,66,0,0,0,0,0,0,0,0
lucie_aubrac,7,22,17,5,77,7,7,5,2,71,3.6,169,67
very_thought_of_you,5.1,8,3,5,37,0,1,0,1,0,3.3,1423,59
chill_factor,3.3,72,5,67,6,3,23,0,23,0,2.7,2079,36
outside_providence,5.6,74,37,37,50,6.2,24,15,9,62,3.2,1355,60
bedrooms_and_hallways,6.3,13,9,4,69,0,1,1,0,100,3.6,615,70
west_beirut,7.2,15,14,1,93,0,1,1,0,100,4.3,382,92
stigmata,4,88,19,69,21,3.2,24,3,21,12,3.1,12281,65
stir_of_echoes,6.4,103,69,34,66,6.4,25,18,7,72,3.4,14833,69
best_laid_plans,5.8,20,9,11,45,0,4,2,2,50,3.1,1229,43
black_cat_white_cat,6.9,18,16,2,88,0,2,2,0,100,4.4,6471,94
minus_man,5.9,34,20,14,58,6.7,8,6,2,75,3,1065,43
whiteboyz,4,15,2,13,13,0,3,0,3,0,2.6,58,27
the-adventures-of-milo-otis,6.6,9,7,2,77,0,0,0,0,0,0,0,0
only_angels_have_wings,8.4,11,11,0,100,0,1,1,0,100,3.8,1509,78
1069707-othello,6.3,38,26,12,68,6.1,11,7,4,63,3.3,2018,66
queens_logic,5.2,7,3,4,42,0,2,0,2,0,2.9,360,29
waynes_world,6.8,45,38,7,84,6.4,7,5,2,71,3.4,45784,80
saturn_3,3.8,7,1,6,14,0,1,0,1,0,0,0,0
soldiers_story,7.2,16,14,2,87,0,2,0,2,0,3.7,1759,80
alice_sweet_alice,0,3,2,1,66,0,0,0,0,0,0,0,0
dont_look_in_the_basement,0,4,0,4,0,0,0,0,0,0,0,0,0
power_of_nightmares_the_rise_of_the_politics_of_fear,8.1,7,6,1,85,8,5,4,1,80,4.5,575,96
i-saw-what-you-did,0,1,0,1,0,0,0,0,0,0,0,0,0
beatles_the_yellow_submarine,7.6,36,34,2,94,7.2,8,7,1,87,3.6,7369,82
american_beauty,8,151,134,17,88,7.8,32,29,3,90,3.8,115181,90
stop-making-sense,8.8,29,28,1,96,0,3,3,0,100,4.4,1700,95
blue_streak,4.8,68,24,44,35,4.4,20,6,14,30,3,13413,65
for_love_of_the_game,6.3,55,35,20,63,6,8,4,4,50,3.3,6328,74
caligula,2.9,28,6,22,21,0,3,0,3,0,2.8,3230,42
beatles_a_hard_days_night,8.2,72,72,0,100,7.9,22,22,0,100,3.9,9274,87
american_splendor,8.3,178,167,11,93,8.6,42,42,0,100,3.7,9157,85
sugar_town,6.2,24,16,8,66,5.9,6,3,3,50,3,177,41
buddy_holly_story,7.3,15,15,0,100,0,0,0,0,0,0,0,0
1007910-fright_night,7.3,27,25,2,92,0,3,2,1,66,3.3,7746,70
fright-night-part-2,4.7,6,2,4,33,0,0,0,0,0,0,0,0
barefoot_in_the_park,6.4,13,11,2,84,0,1,0,1,0,3.7,3074,77
deliverance,8.5,50,47,3,94,5.8,5,2,3,40,3.6,10182,79
excalibur,7.3,25,20,5,80,0,3,1,2,33,3.4,11195,74
lulu_on_the_bridge,3.6,8,0,8,0,0,1,0,1,0,0,0,0
the-pajama-game,7.4,10,9,1,90,0,0,0,0,0,0,0,0
sommersby,5.9,23,14,9,60,7,6,5,1,83,3.1,2582,55
1048880-thumbelina,5.2,8,2,6,25,0,2,1,1,50,3.1,9634,64
1021648-tommy,7.1,15,13,2,86,0,1,1,0,100,3.4,5178,71
hell_night,4.5,6,3,3,50,0,1,0,1,0,3,927,45
operation_condor,6.4,32,22,10,68,6.5,13,11,2,84,3.2,3303,65
operation-condor-2-the-armour-of-the-gods,6.6,8,6,2,75,0,0,0,0,0,0,0,0
1093614-double_jeopardy,4.4,83,21,62,25,4.1,21,4,17,19,3.2,12512,68
jakob_the_liar,4.7,71,21,50,29,4.9,22,7,15,31,3.2,3128,63
mumford,5.9,76,42,34,55,6.7,21,14,7,66,3.2,1155,62
dog_park,4.5,24,8,16,33,4.6,5,1,4,20,2.7,600,30
1093738-guinevere,6.8,33,28,5,84,7.9,8,8,0,100,3,490,45
adventures_of_elmo_in_grouchland,6.7,42,32,10,76,6.3,11,7,4,63,3.2,1136,60
simon_sez,1.9,18,0,18,0,2.4,5,0,5,0,2.2,603,21
mystery_alaska,4.9,78,29,49,37,5.1,26,11,15,42,3.2,4196,66
three_kings,7.8,126,118,8,93,7.5,28,25,3,89,3.3,21498,70
happy_texas,6.7,50,41,9,82,7.4,11,11,0,100,3.1,1535,53
new_rose_hotel,4.2,16,3,13,18,0,2,0,2,0,2.9,682,40
1092147-romance,5.1,31,14,17,45,5.2,8,4,4,50,3,1725,46
napoleon_and_samantha,0,3,2,1,66,0,0,0,0,0,0,0,0
alvarez_kelly,0,3,2,1,66,0,0,0,0,0,0,0,0
and_the_ship_sails_on,6.8,9,8,1,88,0,2,1,1,50,0,0,0
dark_half,5.8,17,10,7,58,0,3,0,3,0,3,2007,43
1009027-gullivers_travels,6.6,10,7,3,70,0,0,0,0,0,0,0,0
monkey_shines,5.4,26,13,13,50,5.4,5,2,3,40,2.9,1393,41
phantasm,6.2,35,22,13,62,0,3,3,0,100,3.4,4777,68
psycho_3,5.2,17,10,7,58,0,4,2,2,50,2.6,2593,31
singin_in_the_rain,9.2,44,44,0,100,8.8,9,9,0,100,3.9,28033,91
sanjuro,8.3,15,15,0,100,0,1,1,0,100,4.2,4523,94
random_hearts,4,87,13,74,14,4.1,26,4,22,15,2.7,2118,28
1093874-superstar,4.5,72,24,48,33,4.1,21,6,15,28,2.9,11034,63
boys_dont_cry,7.9,73,64,9,87,7.9,22,19,3,86,3.7,16491,85
l_ennui,5.5,13,7,6,53,0,2,1,1,50,3,60,50
limey,7.4,79,72,7,91,7.7,24,23,1,95,3.6,4089,76
mating_habits_of_the_earthbound_human,4.3,12,4,8,33,0,1,0,1,0,3.5,709,72
haunting_of_molly_hartley,2.9,34,1,33,2,3.8,8,1,7,12,2.6,18564,23
1017641-risky_business,7.4,43,42,1,97,7.7,6,6,0,100,3.2,11638,61
total_recall,7.2,42,34,8,80,6.8,8,6,2,75,3.3,25031,70
1002830-body_heat,8,36,35,1,97,8.4,5,5,0,100,3.5,2581,74
ferris_buellers_day_off,7.4,46,37,9,80,0,4,1,3,25,3.8,77618,89
year_of_living_dangerously,7.4,25,22,3,88,0,1,0,1,0,3.5,2161,73
children-of-paradise,9,21,20,1,95,8.6,5,5,0,100,4.4,2292,94
high_plains_drifter,7.7,23,22,1,95,0,3,2,1,66,3.7,6781,83
hang_em_high,6.5,14,13,1,92,0,1,1,0,100,3.5,5541,71
citizens_band,0,4,4,0,100,0,0,0,0,0,0,0,0
legend_of_drunken_master,7,74,61,13,82,7.1,24,20,4,83,3.6,7905,83
conformist,8.8,40,40,0,100,8.4,9,9,0,100,4.3,2418,92
hairspray,7.7,205,186,19,90,8,41,40,1,97,3.9,382832,84
1003094-brief_encounter,8.1,29,25,4,86,0,3,2,1,66,4.2,3485,91
1017238-razors_edge,5.4,15,8,7,53,0,1,0,1,0,3.7,879,77
1058966-red,8.5,40,40,0,100,8.2,10,10,0,100,4.2,9557,94
a-time-of-gypsies-dom-za-vesanje,7.1,5,5,0,100,0,2,2,0,100,4.5,2705,96
days_of_heaven,7.9,36,33,3,91,7.3,7,5,2,71,4.2,4575,89
le-feu-follet-a-time-to-live-and-a-time-to-die-the-fire-within,7.7,10,9,1,90,0,3,3,0,100,4.3,616,90
el_amor_brujo,0,2,2,0,100,0,0,0,0,0,0,0,0
lady_eve,8.6,28,28,0,100,0,4,4,0,100,4.1,2031,89
sullivans_travels,8.7,29,29,0,100,0,2,2,0,100,4.2,2289,90
palm_beach_story,8.6,21,21,0,100,0,3,3,0,100,3.9,975,83
man_facing_southeast,0,4,4,0,100,0,0,0,0,0,0,0,0
niagara,6.2,10,8,2,80,0,0,0,0,0,0,0,0
gilda,7.7,15,14,1,93,0,0,0,0,0,0,0,0
south_pacific,6.7,8,7,1,87,0,0,0,0,0,0,0,0
flashdance,4.7,34,10,24,29,4.6,5,1,4,20,3.2,16331,63
indochine,6.3,17,12,5,70,0,2,1,1,50,3.9,1905,84
dirty_dozen,7.9,21,20,1,95,0,2,2,0,100,3.8,7219,86
mikes_murder,0,4,2,2,50,0,0,0,0,0,0,0,0
beatles_the_help,7.3,22,20,2,90,0,2,1,1,50,3.8,5947,85
goldfinger,8.4,48,46,2,95,7.9,6,5,1,83,3.6,22155,83
from_russia_with_love,7.9,45,43,2,95,7.8,5,5,0,100,3.6,17619,79
dr_no,7.6,42,41,1,97,0,4,4,0,100,3.5,19811,78
blue_lagoon,2.7,17,2,15,11,0,4,1,3,25,2.8,7063,55
fistful_of_dollars,8.1,35,34,1,97,0,3,3,0,100,3.8,21677,87
hard_eight,6.9,32,26,6,81,7.1,11,9,2,81,3.7,3180,81
home_alone_2_lost_in_new_york,3.6,24,5,19,20,0,2,1,1,50,3,41991,62
penitentiary,0,1,0,1,0,0,0,0,0,0,0,0,0
penitentiary_2,0,1,0,1,0,0,0,0,0,0,0,0,0
someone_to_watch_over_me,6.2,17,14,3,82,0,1,0,1,0,3,863,38
naturally-native,0,0,0,0,0,0,0,0,0,0,0,0,0
fight_club,7.3,149,120,29,80,5.9,27,17,10,62,4.2,268913,95
beefcake,5.4,7,4,3,57,0,2,1,1,50,3.4,279,63
story_of_us,4.5,81,23,58,28,4.1,25,4,21,16,3,5089,57
fever_pitch,6.2,172,110,62,63,6,38,19,19,50,3,14004,62
joe_the_king,6,24,15,9,62,5.8,5,1,4,20,3.5,396,67
julien_donkeyboy,4.6,33,8,25,24,5.4,6,3,3,50,3.6,1576,73
omega_code,3,24,2,22,8,4.2,6,2,4,33,2.6,796,40
straight_story,8.1,86,82,4,95,8,26,25,1,96,4,7407,89
1001572-bad_seed,7.6,15,13,2,86,0,0,0,0,0,0,0,0
time_bandits,8,36,34,2,94,6.9,5,4,1,80,3.5,9753,74
man_and_a_woman,6.3,12,9,3,75,0,3,1,2,33,4,1548,86
fitzcarraldo,7.6,22,18,4,81,0,3,2,1,66,4.3,4213,93
all_that_jazz,7.4,30,26,4,86,0,4,2,2,50,3.9,3397,84
red_sorghum,7.6,7,7,0,100,0,1,1,0,100,0,0,0
crimes_and_misdemeanors,7.9,38,35,3,92,7.3,5,4,1,80,4,6179,90
vampire_bat,0,4,2,2,50,0,0,0,0,0,0,0,0
unhitched,0,1,1,0,100,0,0,0,0,0,0,0,0
bringing_out_the_dead,6.7,105,75,30,71,6.6,25,18,7,72,3.2,7444,65
crazy_in_alabama,4.5,55,17,38,30,4.7,20,6,14,30,3.1,1384,55
three_to_tango,4.3,64,18,46,28,4.5,18,7,11,38,2.7,3780,46
body_shots,4,28,3,25,10,5.5,6,2,4,33,2.5,624,27
brother_can_you_spare_a_dime,0,0,0,0,0,0,0,0,0,0,0,0,0
guardian,5.2,143,54,89,37,5.2,34,11,23,32,3.7,58919,83
ipcress_file,7.7,23,23,0,100,0,3,3,0,100,3.8,1386,83
on_any_sunday,0,3,2,1,66,0,1,1,0,100,4.4,129,91
1017712-robocop,7.7,42,37,5,88,7.3,7,6,1,85,3.1,18381,71
robocop_2,4.5,31,11,20,35,4,5,1,4,20,2.7,9580,38
who_framed_roger_rabbit,8.3,42,41,1,97,7.7,8,7,1,87,3.5,33318,75
melvin_and_howard,8.2,16,16,0,100,0,1,1,0,100,3.4,453,61
for_your_eyes_only,6.2,35,25,10,71,6,5,3,2,60,3.3,10042,64
licence_to_kill,5.8,35,25,10,71,5.5,8,4,4,50,3.1,12088,56
live_and_let_die,5.9,36,23,13,63,4.1,6,1,5,16,3.3,13025,66
rawhead_rex,4.4,5,2,3,40,0,0,0,0,0,0,0,0
thunderball,7,33,30,3,90,6.2,5,4,1,80,3.4,12807,70
city_lights,9,37,37,0,100,8.8,8,8,0,100,4.3,7937,94
1093881-house_on_haunted_hill,4.4,53,13,40,24,3.5,11,2,9,18,2.9,13288,49
music_of_the_heart,6.6,75,51,24,68,6.1,19,12,7,63,3.5,3231,68
being_john_malkovich,8,116,107,9,92,7.7,26,24,2,92,3.6,52443,85
dreaming_of_joseph_lees,4.8,13,4,9,30,0,4,3,1,75,3.5,62,58
man_of_the_century,6.6,16,12,4,75,5.7,5,2,3,40,3.7,246,74
princess-mononoke,7.7,83,77,6,92,7.7,24,23,1,95,4.1,44616,94
suburbans,3,10,0,10,0,0,2,0,2,0,2.5,700,23
my_best_fiend,7,24,19,5,79,6.8,5,4,1,80,4,1638,90
train_of_life,6.4,18,12,6,66,0,4,2,2,50,4.3,854,93
1093976-bachelor,3.5,66,6,60,9,3.4,20,1,19,5,2.5,3470,34
bone_collector,4.7,84,23,61,27,4.7,23,7,16,30,3.3,26317,68
inside_man,7.3,195,168,27,86,7.5,40,35,5,87,3.7,84980,81
american_movie,8.3,46,43,3,93,8.9,7,7,0,100,4,3544,87
1094041-last_night,7.2,49,41,8,83,7.1,9,7,2,77,3.8,1691,84
rosetta,7.2,22,19,3,86,8.7,5,5,0,100,3.9,880,82
they_shoot_horses_dont_they,7.3,23,19,4,82,0,3,3,0,100,3.9,1522,87
battling_butler,6,5,4,1,80,0,1,0,1,0,3.7,249,75
bride_of_reanimator,5.2,15,7,8,46,0,3,1,2,33,3.1,1904,51
bustin_loose,0,4,3,1,75,0,0,0,0,0,0,0,0
1004502-coma,6.6,21,16,5,76,0,3,1,2,33,3.2,1526,55
creepshow,6,27,18,9,66,0,4,2,2,50,3.3,6768,67
creepshow_2,3.7,19,5,14,26,0,4,2,2,50,3,3260,49
reanimator,7.7,38,35,3,92,0,4,3,1,75,3.6,7434,78
drugstore_cowboy,8,27,27,0,100,9,6,6,0,100,3.7,4507,82
falling_down,6.6,44,33,11,75,6.4,8,5,3,62,3.5,19292,79
funhouse,5.6,12,7,5,58,0,0,0,0,0,0,0,0
1008166-general,8.9,38,35,3,92,0,4,2,2,50,4.4,3785,93
1016359-piranha,6.4,22,15,7,68,0,0,0,0,0,0,0,0
rough_night_in_jericho,0,3,1,2,33,0,1,0,1,0,3.1,322,34
slaughterhouse_five,7.4,13,10,3,76,0,0,0,0,0,0,0,0
slaughterhouse_five,7.4,13,10,3,76,0,0,0,0,0,0,0,0
taming-of-the-shrew1983,0,0,0,0,0,0,0,0,0,0,0,0,0
1015095-nighthawks,6.2,14,10,4,71,0,2,2,0,100,3.1,1535,52
yojimbo,8.8,34,33,1,97,8,5,4,1,80,4.4,10522,96
repo_the_genetic_opera,4.5,54,18,36,33,3.6,14,2,12,14,3.7,8433,74
omega_man,5.6,32,19,13,59,0,4,2,2,50,3.3,5147,56
spaceballs,6.3,23,15,8,65,0,1,0,1,0,3.5,54973,80
robin_hood_prince_of_thieves,5.2,27,15,12,55,0,2,1,1,50,3.4,30722,72
1014061-mister_roberts,7.5,17,17,0,100,0,0,0,0,0,0,0,0
quest_for_fire,7,14,11,3,78,0,1,1,0,100,3.5,2238,71
little_big_man,7.9,25,24,1,96,0,2,2,0,100,3.8,3720,84
face_in_the_crowd,7.8,21,19,2,90,0,3,3,0,100,4.2,1221,93
trading_places,7.2,36,32,4,88,6.8,5,4,1,80,3.5,12785,82
meatballs,6.2,28,20,8,71,0,3,2,1,66,3,3676,54
meatballs_2,0,0,0,0,0,0,0,0,0,0,0,0,0
meatballs_3,0,0,0,0,0,0,0,0,0,0,0,0,0
meatballs_4,0,2,0,2,0,0,0,0,0,0,0,0,0
dead_again,7.3,37,31,6,83,7,5,3,2,60,3.6,2979,75
peters_friends,6.3,25,19,6,76,0,2,1,1,50,3.6,1706,73
incredibly_true_adventures_of_two_girls_in_love,6.5,9,6,3,66,0,3,1,2,33,3.5,1299,70
under_the_rainbow,0,4,0,4,0,0,2,0,2,0,3.1,194,46
how_i_won_the_war,5.7,12,7,5,58,0,4,0,4,0,3.3,537,58
light_it_up,4.9,47,18,29,38,5.3,17,8,9,47,3.6,1219,76
anywhere_but_here,6.4,86,55,31,63,6.7,23,15,8,65,3,4760,52
dogma,6.3,126,85,41,67,5.8,28,14,14,50,3.6,61754,84
messenger_the_story_of_joan_of_arc,4.5,72,22,50,30,3.4,21,1,20,4,3.1,8110,57
pokemon-the-first-movie-mewtwo-vs-mew,3.6,75,11,64,14,3.7,22,3,19,13,2.8,10617,55
felicias_journey,7.4,40,35,5,87,7.8,8,8,0,100,3.4,694,66
oxygen,6.5,10,7,3,70,0,0,0,0,0,0,0,0
wheres_marlowe,4.4,11,2,9,18,0,3,0,3,0,3,183,46
1016397-planet_of_the_apes,7.4,44,39,5,88,5.5,5,3,2,60,3.4,12844,80
1037024-commitments,7.5,38,34,4,89,6.5,9,7,2,77,3.7,4765,88
holiday_inn,7.1,20,20,0,100,0,3,3,0,100,4,3215,87
longest_day,7.5,12,11,1,91,0,0,0,0,0,0,0,0
1039642-poison_ivy,5,26,11,15,42,4.2,6,1,5,16,2.7,5842,40
poison_ivy_the_new_seduction,0,3,0,3,0,0,0,0,0,0,0,0,0
1077642-nothing_to_lose,5.1,23,6,17,26,5.7,5,1,4,20,3.1,5245,67
tora_tora_tora,6.3,17,12,5,70,0,2,1,1,50,3.6,3254,79
women_on_the_verge_of_a_nervous_breakdown,7.6,26,23,3,88,0,4,4,0,100,4,6254,88
verdict,7.8,24,23,1,95,0,3,2,1,66,3.8,2332,85
the-effect-of-gamma-rays-on-maninthemoon-marigolds,0,0,0,0,0,0,0,0,0,0,0,0,0
adventures_of_buckaroo_banzai,6.4,34,23,11,67,0,3,2,1,66,3.4,3969,69
stand_and_deliver,6,14,9,5,64,0,1,0,1,0,3.6,2645,78
moonstruck,7.7,36,33,3,91,7.3,6,5,1,83,3.4,7943,77
the-sandpiper2005,0,0,0,0,0,0,0,0,0,0,0,0,0
jeremiah_johnson,7.1,14,13,1,92,0,2,2,0,100,3.9,3595,85
repulsion,8.8,44,44,0,100,8.3,6,6,0,100,4,4466,87
irma_la_douce,7.4,13,11,2,84,0,2,1,1,50,3.7,1630,76
42_up,7.8,31,28,3,90,7.8,8,7,1,87,4,803,88
liberty_heights,7.3,45,39,6,86,7.8,11,11,0,100,3.4,1048,71
1093843-mansfield_park,6.9,66,50,16,75,6.3,18,10,8,55,3.6,6288,77
sleepy_hollow,6.3,124,84,40,67,6.2,30,20,10,66,3.5,93949,79
morir_o_no,0,1,0,1,0,0,0,0,0,0,0,0,0
all_about_my_mother,8,80,78,2,97,8,23,22,1,95,4.2,16912,93
living_dead_girl,0,2,1,1,50,0,0,0,0,0,0,0,0
march_of_the_wooden_soldiers,8.4,12,12,0,100,0,2,2,0,100,3.6,865,78
scrooged,5.8,38,24,14,63,3.8,6,1,5,16,3.3,11201,68
last_chance_harvey,6.2,146,102,44,69,6.1,27,19,8,70,3.2,14302,52
bicycle_thief,8.8,47,45,2,95,8.8,7,7,0,100,4.3,8603,94
matewan,8.3,17,17,0,100,0,0,0,0,0,0,0,0
kagemusha,7.5,19,16,3,84,0,2,1,1,50,4.2,4005,91
chushingura,0,1,0,1,0,0,0,0,0,0,0,0,0
mccabe_and_mrs_miller,8.4,35,31,4,88,6.3,5,3,2,60,4,2372,85
maurice,7,10,9,1,90,0,1,1,0,100,3.9,2148,82
grapes_of_wrath,8.9,36,36,0,100,8,5,5,0,100,3.8,4868,85
1014536-my_man_godfrey,8.4,26,26,0,100,8,6,6,0,100,4.1,1791,90
shop_around_the_corner,8.4,20,20,0,100,0,4,4,0,100,4.1,3559,89
natural,7,31,25,6,80,5.8,5,2,3,40,3.7,6978,86
shampoo,6.1,28,17,11,60,5,5,1,4,20,3.2,1397,52
river_runs_through_it,6.8,38,31,7,81,7.4,9,8,1,88,3.5,13036,79
1007141-fatal_attraction,6.8,42,34,8,80,6.7,7,5,2,71,3.2,8130,67
jagged_edge,6.7,26,22,4,84,6.2,5,3,2,60,3.2,969,54
stanley_and_iris,4,14,4,10,28,0,4,1,3,25,3.1,683,44
midnight_run,7.7,26,25,1,96,0,2,1,1,50,3.6,5155,82
1032970-awakenings,6.7,28,25,3,89,0,1,1,0,100,3.6,10377,85
come_see_the_paradise,5.5,9,6,3,66,0,2,1,1,50,3.5,180,61
backdraft,6,39,28,11,71,4.4,7,3,4,42,3.3,17142,73
fisher_king,7,50,43,7,86,6.8,8,6,2,75,3.6,8960,83
frozen_river,7.3,125,109,16,87,7.9,26,24,2,92,3.2,9338,71
north_country,6.7,166,114,52,68,6.8,38,26,12,68,3.5,14739,72
places_in_the_heart,8,20,20,0,100,0,3,3,0,100,3.7,1290,80
night_mother,0,1,1,0,100,0,0,0,0,0,0,0,0
end_of_days,3.7,98,11,87,11,3.3,24,1,23,4,2.8,14087,41
toy_story,9,73,73,0,100,8.5,17,17,0,100,3.7,102338,81
10008754-flawless,5.7,90,50,40,55,6,17,12,5,70,3.3,5982,56
1093854-miss_julie,5.6,21,8,13,38,5.2,6,1,5,16,3.2,300,57
1084873-ride_with_the_devil,6.2,64,40,24,62,5.9,18,10,8,55,3.3,1734,62
1093901-tumbleweeds,7,64,54,10,84,7.1,22,19,3,86,3.5,368,66
bay_of_blood,7.5,9,8,1,88,0,0,0,0,0,0,0,0
the-distinguished-gentleman,4,14,2,12,14,0,2,0,2,0,2.8,1961,40
1057462-hitchhiker,7.6,5,5,0,100,0,0,0,0,0,0,0,0
santa_fe_trail,0,3,3,0,100,0,0,0,0,0,0,0,0
agnes_browne,5.3,26,10,16,38,5.8,6,2,4,33,3.5,307,70
1093671-end_of_the_affair,6.6,66,44,22,66,6.5,16,9,7,56,3.6,3227,73
1093671-end_of_the_affair,6.6,66,44,22,66,6.5,16,9,7,56,3.6,3227,73
holy_smoke,5.6,73,32,41,43,5.4,22,8,14,36,3,2300,46
map_of_the_world,6.4,54,35,19,64,6.6,17,12,5,70,3.2,587,51
sweet_and_lowdown,6.8,59,46,13,77,6.5,16,11,5,68,3.6,3877,76
bonfire_of_the_vanities,3.8,30,7,23,23,0,2,0,2,0,2.6,3216,28
broadway_damage,3.5,7,2,5,28,0,1,0,1,0,3,241,43
1033622-daddy_long_legs,0,1,1,0,100,0,0,0,0,0,0,0,0
1008437-go_west,6.5,9,8,1,88,0,0,0,0,0,0,0,0
grand_illusion,9.2,34,33,1,97,0,4,4,0,100,4.3,2864,93
great_santini,7.8,17,16,1,94,0,1,1,0,100,3.6,592,74
james_dean_story,0,1,1,0,100,0,0,0,0,0,0,0,0
stealing_home,3.4,9,2,7,22,0,1,0,1,0,3.5,936,71
tarzan_the_fearless,0,1,1,0,100,0,0,0,0,0,0,0,0
three_ages,7.4,7,7,0,100,0,0,0,0,0,0,0,0
two_jakes,5.4,16,10,6,62,0,2,2,0,100,2.9,1401,37
u2_rattle_and_hum,5.7,12,8,4,66,0,0,0,0,0,0,0,0
1009456-hell_in_the_pacific,6.8,10,8,2,80,0,0,0,0,0,0,0,0
glass_bottom_boat,5.6,6,3,3,50,0,0,0,0,0,0,0,0
cradle_will_rock,6.2,66,42,24,63,5.9,14,10,4,71,3.4,1693,65
deuce_bigalow_male_gigolo,4,73,17,56,23,3.2,18,1,17,5,2.9,18036,55
green_mile,6.8,128,99,29,77,6.2,32,23,9,71,4.1,124792,93
cider_house_rules,6.6,109,77,32,70,6.5,25,17,8,68,3.4,9660,75
1093655-diamonds,4,34,9,25,26,3.8,10,3,7,30,2.7,365,32
punisher_war_zone,4.2,96,25,71,26,3.7,21,1,20,4,3,29393,47
bat_whispers,0,4,2,2,50,0,1,0,1,0,3.4,96,67
last_picture_show,8.6,33,33,0,100,8.5,5,5,0,100,4,3677,88
1002628-blood_on_the_sun,0,3,3,0,100,0,0,0,0,0,0,0,0
1093611-anna_and_the_king,5.9,97,49,48,50,5.3,28,10,18,35,3.2,10877,63
bicentennial_man,4.8,93,35,58,37,4.6,23,6,17,26,3,22610,58
stuart_little_2,6.9,114,95,19,83,6.9,29,26,3,89,2.7,10893,44
emperor_and_the_assassin,7.4,34,29,5,85,7.2,5,3,2,60,3.7,1522,76
fantasia_2000,7,78,64,14,82,5.9,22,14,8,63,3.3,9364,67
magnolia,7.5,138,114,24,82,6.8,32,25,7,78,3.7,39673,88
1093905-onegin,5.5,20,8,12,40,0,4,1,3,25,3.6,1473,69
simpatico,4.6,59,14,45,23,4.3,18,3,15,16,2.4,294,18
topsyturvy,7.8,83,74,9,89,7.9,19,18,1,94,3.6,1113,73
1088532-boiling_point,6.8,7,6,1,85,0,1,1,0,100,3.5,702,66
brenda_starr,0,0,0,0,0,0,0,0,0,0,0,0,0
carnal_knowledge,7.7,26,23,3,88,0,4,3,1,75,3.5,1350,70
easy_rider,7.9,37,32,5,86,0,4,2,2,50,3.7,13558,81
falcon_and_the_snowman,7.3,15,13,2,86,0,1,1,0,100,3.3,1167,62
room_at_the_top,8.3,10,10,0,100,0,0,0,0,0,0,0,0
1022299-ulysses,0,2,2,0,100,0,0,0,0,0,0,0,0
any_given_sunday,5.5,118,58,60,49,5.5,30,16,14,53,3.3,21068,70
1093579-man_on_the_moon,6.2,117,73,44,62,5.3,31,16,15,51,3.3,15027,74
galaxy_quest,7.2,111,99,12,89,6.9,27,22,5,81,3,19804,67
talented_mr_ripley,7.3,125,103,22,82,6.9,31,24,7,77,3.3,18951,75
next_friday,3.9,62,13,49,20,4.1,21,5,16,23,3.2,25065,77
1010242-hurricane,0,1,1,0,100,0,0,0,0,0,0,0,0
angelas_ashes,5.7,84,44,40,52,5.3,26,10,16,38,3.6,4588,79
play_it_to_the_bone,4,78,9,69,11,3.9,24,4,20,16,2.7,1727,29
titus,6.5,74,50,24,67,6,21,12,9,57,3.7,4498,83
mr_death_the_rise_and_fall_of_fred_a_leuchter_jr,8.4,38,38,0,100,9.2,5,5,0,100,3.8,935,85
third_miracle,6.2,33,22,11,66,7.6,5,5,0,100,3.2,499,54
1018324-scarface,7.5,50,44,6,88,8,5,4,1,80,4.1,121090,93
snow_falling_on_cedars,5.2,88,35,53,39,4.6,26,7,19,26,3.4,2061,67
girl_interrupted,5.7,111,59,52,53,5.1,30,12,18,40,3.5,36814,83
life_and_times_of_hank_greenberg,7.4,45,43,2,95,7.4,9,8,1,88,3.5,218,69
my_dog_skip,6.7,80,58,22,72,6.6,24,17,7,70,3.1,5324,63
1084878-supernova,3.2,60,6,54,10,3.2,18,3,15,16,2.4,3150,21
1099316-quarry,4.5,5,1,4,20,0,0,0,0,0,0,0,0
heavenly_creatures,8.3,41,39,2,95,7.8,9,9,0,100,3.7,8208,82
way_we_were,6,19,12,7,63,0,3,1,2,33,3.7,5344,82
tess_of_the_storm_country,0,0,0,0,0,0,0,0,0,0,0,0,0
stalag_17,8.3,28,27,1,96,8.1,6,6,0,100,4.2,3492,92
presidio,4.8,13,6,7,46,0,1,0,1,0,3,1838,39
papillon,7.7,13,12,1,92,0,2,1,1,50,0,0,0
pal_joey,6.5,7,5,2,71,0,0,0,0,0,0,0,0
last_detail,7.8,24,22,2,91,0,3,3,0,100,3.9,1988,85
five_easy_pieces,8.2,30,25,5,83,6.5,5,3,2,60,3.9,4148,85
even_dwarfs_started_small,7.9,8,8,0,100,0,2,2,0,100,3.8,1310,76
dead_calm,7.5,21,20,1,95,0,1,1,0,100,3.1,4726,57
1002993-boys_from_brazil,6.2,26,17,9,65,0,2,0,2,0,3.5,1963,68
1055755-black_sunday,7.2,15,12,3,80,0,1,0,1,0,3.8,1726,79
against_all_odds,5.6,9,6,3,66,0,1,1,0,100,3,1230,46
snows_of_kilimanjaro,0,4,4,0,100,0,0,0,0,0,0,0,0
national_lampoons_loaded_weapon_1,3.5,22,3,19,13,0,4,0,4,0,2.8,4689,50
loves_of_carmen,0,1,0,1,0,0,0,0,0,0,0,0,0
fast_times_at_ridgemont_high,6.7,44,35,9,79,3.9,6,2,4,33,3.5,26337,76
cry_in_the_dark,6.8,20,18,2,90,0,1,1,0,100,3.3,1554,63
batman_mask_of_the_phantasm,6.9,23,20,3,86,0,3,1,2,33,3.4,14817,73
american_flyers,5.5,20,12,8,60,0,3,0,3,0,3.2,1640,57
voyage_of_the_damned,5.2,5,4,1,80,0,0,0,0,0,0,0,0
vampyros_lesbos,5.6,6,3,3,50,0,1,0,1,0,3,1298,45
1019828-star_is_born,7.3,11,11,0,100,0,0,0,0,0,0,0,0
1037447-poison,7,12,10,2,83,0,1,1,0,100,3.5,529,65
pacific_heights,5.2,22,10,12,45,0,2,0,2,0,3.1,1624,51
night-tide,0,0,0,0,0,0,0,0,0,0,0,0,0
draughtsmans_contract,8,17,17,0,100,0,2,2,0,100,3.9,1191,84
ucarmen-ekhayelitsha,7.4,20,19,1,95,7.8,7,7,0,100,3.2,1204,50
zed_and_two_noughts,6.7,19,15,4,78,0,1,1,0,100,4,1255,86
woman_in_the_dunes,8.7,14,14,0,100,0,1,1,0,100,4.3,1517,92
down_to_you,3.2,58,2,56,3,2.8,16,0,16,0,2.7,6516,51
hellhounds_on_my_trail_the_afterlife,0,0,0,0,0,0,0,0,0,0,0,0,0
1015389-odessa_file,5.7,14,9,5,64,0,2,0,2,0,3.4,663,64
saphead,0,0,0,0,0,0,0,0,0,0,0,0,0
seven-chances,8.8,12,12,0,100,0,0,0,0,0,0,0,0
where_the_buffalo_roam,4.7,12,3,9,25,0,1,0,1,0,3.6,5671,75
kestrels_eye,6.6,7,5,2,71,0,1,1,0,100,3.2,281,38
1094646-eye_of_the_beholder,3.4,86,8,78,9,3.1,20,1,19,5,2.7,2529,34
isnt_she_great,4,60,15,45,25,3.7,22,5,17,22,2.9,563,41
big_tease,5.7,39,22,17,56,5.7,15,9,6,60,3.2,496,56
cup,6.9,33,28,5,84,7,7,6,1,85,4,324,85
santitos1999,6.3,7,4,3,57,0,1,1,0,100,3.3,199,58
encino_man,3.1,29,4,25,13,2.6,6,0,6,0,2.9,9527,58
1008623-goodbye_girl,6.5,15,12,3,80,0,1,1,0,100,3.8,1711,84
i_am_cuba,8.6,31,31,0,100,8.9,7,7,0,100,4.2,1082,91
1042135-malcolm_x,7.4,51,46,5,90,6.6,9,6,3,66,3.8,11524,90
sister_act,5.6,18,12,6,66,0,2,1,1,50,3.1,27888,66
sister_act_2_back_in_the_habit,3,28,2,26,7,3.5,8,1,7,12,3,21141,66
hand_that_rocks_the_cradle,5.6,32,18,14,56,5.2,6,3,3,50,3.1,4973,60
1042538-alive,6.4,21,15,6,71,0,3,1,2,33,3.3,5360,68
agnes_of_god,5.5,17,9,8,52,0,1,0,1,0,3.2,1316,55
1042193-scent_of_a_woman,7.2,32,30,2,93,0,3,3,0,100,3.7,23625,90
waynes_world,6.8,45,38,7,84,6.4,7,5,2,71,3.4,45784,80
waynes_world_2,5.8,42,25,17,59,7.1,7,6,1,85,3.1,24416,64
for_their_own_good,0,0,0,0,0,0,0,0,0,0,0,0,0
patriot_games,6,28,21,7,75,3.8,5,0,5,0,3.4,13313,70
1042108-bodyguard,4.8,24,9,15,37,0,2,1,1,50,2.9,15937,61
death-becomes-them-the-musical,0,0,0,0,0,0,0,0,0,0,0,0,0
far_and_away,5.2,21,10,11,47,0,2,0,2,0,3.1,11238,61
howards_end,8.2,34,31,3,91,9.8,5,5,0,100,3.7,3467,80
1040379-singles,6.9,40,32,8,80,7.5,8,6,2,75,3.4,4630,70
twin-peaks-fire-walk-with-me,6.2,50,31,19,62,4.4,5,2,3,40,3.6,10347,79
white_men_cant_jump,6.3,37,29,8,78,6,7,5,2,71,3,9040,61
buffy_the_vampire_slayer,4.1,34,11,23,32,3.9,6,2,4,33,2.8,18735,44
man_bites_dog,7.3,14,12,2,85,0,1,1,0,100,4.1,6544,90
el_mariachi,7,25,23,2,92,7.6,5,5,0,100,3.5,11481,73
stop_or_my_mom_will_shoot,2.5,23,1,22,4,0,4,0,4,0,2.2,5278,26
1041862-forever_young,5.3,16,8,8,50,0,1,0,1,0,3.1,9230,55
1038990-cutting_edge,6.1,12,7,5,58,0,3,2,1,66,3.3,6209,76
1040322-of_mice_and_men,7.9,25,24,1,96,8.9,6,6,0,100,3.5,6505,77
bad_lieutenant,6.9,38,29,9,76,6.7,10,7,3,70,3.5,4087,73
scream_3,5.2,94,36,58,38,5.1,23,9,14,39,2.8,28349,49
single_white_female,5.3,39,23,16,58,4.9,8,4,4,50,2.9,3934,49
boondock_saints,4,21,4,17,19,0,1,0,1,0,4.2,104281,93
gun_shy,4.5,42,10,32,23,3.8,10,2,8,20,2.9,1203,40
gendernauts,0,2,1,1,50,0,0,0,0,0,0,0,0
gone_baby_gone,7.7,164,154,10,93,7.4,36,33,3,91,3.8,95109,84
brandon_teena_story,6.2,12,8,4,66,0,2,2,0,100,3.7,649,70
different_for_girls,5.9,24,12,12,50,6.7,10,7,3,70,3.5,391,65
minnie_and_moskowitz,7.3,10,8,2,80,0,2,1,1,50,0,0,0
they-might-be-giants,7.1,9,7,2,77,0,0,0,0,0,0,0,0
beach,4.4,116,22,94,18,3.9,31,4,27,12,2.9,21479,59
snow_day,4.2,62,16,46,25,4,20,5,15,25,2.5,4272,33
the-tigger-movie,5.9,70,43,27,61,5.7,19,10,9,52,3.2,5413,63
not_one_less,7.6,42,40,2,95,7.8,10,10,0,100,4,1451,88
big_combo,7,12,11,1,91,0,3,2,1,66,3.5,764,69
conceiving-ada,6.6,11,9,2,81,0,1,1,0,100,3.2,57,50
1006438-eaten_alive,4.4,10,1,9,10,0,0,0,0,0,0,0,0
raining_stones,8,11,11,0,100,0,4,4,0,100,3.9,560,88
to_sir_with_love,7.1,23,21,2,91,0,4,3,1,75,3.8,4209,85
1095081-boiler_room,6.4,97,65,32,67,6.7,22,17,5,77,3.4,7689,75
pitch_black,5.6,100,55,45,55,4.9,26,10,16,38,3.4,39767,79
whole_nine_yards,5.2,93,42,51,45,5,25,10,15,40,3.2,16066,67
beautiful_people,6.7,24,19,5,79,7.6,6,6,0,100,3.9,289,82
black_tar_heroin_the_dark_end_of_the_street,0,0,0,0,0,0,0,0,0,0,0,0,0
blue_collar_comedy_tour_the_movie,6.8,13,12,1,92,7,8,8,0,100,3.6,6829,82
1002732-bluebeard,7.6,7,7,0,100,0,0,0,0,0,0,0,0
city_lights,9,37,37,0,100,8.8,8,8,0,100,4.3,7937,94
flamingo_kid,6.8,17,15,2,88,0,4,4,0,100,2.8,700,39
a-dogs-life,0,0,0,0,0,0,0,0,0,0,0,0,0
karate_kid,6.9,41,37,4,90,6.9,5,4,1,80,3.3,20688,71
man_from_laramie,7.6,6,6,0,100,0,0,0,0,0,0,0,0
national_lampoons_class_reunion,2.4,6,0,6,0,0,0,0,0,0,0,0,0
big_trees,0,1,0,1,0,0,0,0,0,0,0,0,0
reindeer_games,4.2,86,21,65,24,4.4,26,8,18,30,2.5,4918,33
wonder_boys,7.2,122,99,23,81,7.1,28,23,5,82,3.5,7544,79
deterrence,5.3,38,17,21,44,5.3,12,5,7,41,3.2,258,54
judy-berlin,7.1,29,23,6,79,7.8,5,4,1,80,3.4,156,73
mifune,6.7,30,22,8,73,8,6,6,0,100,3.8,534,84
3_strikes,2.3,29,0,29,0,2.4,11,0,11,0,3.1,1088,60
1138933-chain_of_fools,0,0,0,0,0,0,0,0,0,0,0,0,0
drowning_mona,4.4,75,22,53,29,4.2,23,7,16,30,2.7,2361,40
next_best_thing,3.6,91,17,74,18,3.3,27,3,24,11,2.6,3665,36
1095351-1095351-what_planet_are_you_from,5,77,32,45,41,4.1,23,7,16,30,2.5,1064,25
beyond_the_mat,6.7,65,53,12,81,6.2,18,13,5,72,3.6,1609,79
ghost_dog_the_way_of_the_samurai,7,91,74,17,81,6.2,25,16,9,64,3.7,11931,82
year_my_voice_broke,7.1,15,14,1,93,0,4,4,0,100,4.1,242,89
splendor_in_the_grass,7.2,13,11,2,84,0,0,0,0,0,0,0,0
my_tutor,0,0,0,0,0,0,0,0,0,0,0,0,0
legend_of_lobo,0,1,0,1,0,0,0,0,0,0,0,0,0
killing_of_sister_george,6.5,12,9,3,75,0,1,0,1,0,4,248,85
key_largo,8.1,26,25,1,96,0,3,2,1,66,0,0,0
10007131-jaibait,4.3,18,3,15,16,3.9,7,1,6,14,3.7,257,62
it-happened-here1965,6.9,6,4,2,66,0,1,1,0,100,3.4,278,63
ill-never-forget-whatsisname,0,1,1,0,100,0,0,0,0,0,0,0,0
for_all_mankind,8.1,14,13,1,92,0,1,1,0,100,4.1,579,91
cross_of_iron,6.3,14,11,3,78,0,1,0,1,0,0,0,0
bride_of_the_monster,3.8,8,3,5,37,0,0,0,0,0,0,0,0
1002930-born_yesterday,8.1,20,19,1,95,0,2,1,1,50,3.9,1132,86
1000914-and_god_created_woman,6.2,11,8,3,72,0,1,0,1,0,3,1435,52
1002611-blood_feast,4.2,11,4,7,36,0,0,0,0,0,0,0,0
charlie_the_lonesome_cougar,0,1,1,0,100,0,0,0,0,0,0,0,0
never_cry_wolf,7.7,17,17,0,100,0,4,4,0,100,3.7,962,80
1015084-night_visitor,0,4,1,3,25,0,1,0,1,0,3,54,50
1016152-perils_of_pauline,0,0,0,0,0,0,0,0,0,0,0,0,0
1017123-raisin_in_the_sun,8.1,12,12,0,100,0,1,1,0,100,3.8,1378,83
two_thousand_maniacs,4.5,13,4,9,30,0,0,0,0,0,0,0,0
browns-requiem,6,6,3,3,50,0,0,0,0,0,0,0,0
american_women,5.4,19,6,13,31,0,3,1,2,33,3.1,100,56
the-last-mission,0,0,0,0,0,0,0,0,0,0,0,0,0
ninth_gate,4.9,85,35,50,41,4,24,6,18,25,3.2,23993,60
eastwest,6.6,29,20,9,68,6.3,5,2,3,40,4,588,85
defending_your_life,7.6,27,26,1,96,0,3,3,0,100,3.6,2592,76
breaking_away,8.2,33,31,2,93,8.3,5,5,0,100,3.9,2650,84
hoosiers,7.4,42,37,5,88,7.4,9,8,1,88,3.7,10169,87
bull_durham,7.9,45,44,1,97,7.9,7,7,0,100,3.4,8264,78
dog_day_afternoon,8.5,35,34,1,97,6.9,6,5,1,83,4,18531,91
american_graffiti,8.3,32,31,1,96,0,4,4,0,100,3.6,12630,78
asphalt_jungle,8.4,25,24,1,96,0,0,0,0,0,0,0,0
searchers,8.8,41,40,1,97,8.3,5,5,0,100,4,8713,87
devils_brigade,0,4,3,1,75,0,1,0,1,0,3.5,612,71
big_country,6.8,9,9,0,100,0,0,0,0,0,0,0,0
any_number_can_win,0,3,2,1,66,0,0,0,0,0,0,0,0
nerakhoon,7.6,29,27,2,93,7.7,12,12,0,100,3.6,219,72
bound_for_glory,7.3,16,14,2,87,0,1,1,0,100,3.6,461,74
1003086-bridge_at_remagen,0,3,0,3,0,0,0,0,0,0,0,0,0
buck_and_the_preacher,0,0,0,0,0,0,0,0,0,0,0,0,0
daughters_of_the_dust,7.2,8,7,1,87,0,2,2,0,100,3.9,285,78
destination_moon,4.7,9,5,4,55,0,0,0,0,0,0,0,0
hangmen_also_die,0,3,3,0,100,0,0,0,0,0,0,0,0
1089805-ogre,7,9,8,1,88,0,2,2,0,100,3.8,262,79
beach,4.4,116,22,94,18,3.9,31,4,27,12,2.9,21479,59
railroaded,0,4,3,1,75,0,0,0,0,0,0,0,0
taking_of_pelham_one_two_three,8.2,32,32,0,100,7.9,5,5,0,100,3.9,2926,86
volunteers,4.6,8,4,4,50,0,0,0,0,0,0,0,0
1037756-jfk,7.5,52,43,9,82,7.1,9,7,2,77,3.7,15334,84
whos_harry_crumb,3.6,10,3,7,30,0,0,0,0,0,0,0,0
harry_and_the_hendersons,4.8,17,7,10,41,0,0,0,0,0,0,0,0
lets_get_harry,0,0,0,0,0,0,0,0,0,0,0,0,0
shanghai_surprise,2.3,7,1,6,14,0,0,0,0,0,0,0,0
whos-that-girl,3.2,13,3,10,23,0,1,1,0,100,0,0,0
shedevil,4.5,17,7,10,41,0,1,1,0,100,2.6,2831,44
date_with_an_angel,3.4,7,1,6,14,0,2,0,2,0,3.1,926,59
1002571-blind_date,4.1,22,5,17,22,0,3,1,2,33,2.9,2983,44
nadine,5,10,4,6,40,0,1,0,1,0,2.8,404,21
muppet_movie,7.8,37,33,4,89,0,3,2,1,66,3.5,8541,79
great_muppet_caper,6,17,12,5,70,0,3,1,2,33,3.3,4174,72
muppets_take_manhattan,6.7,19,15,4,78,0,3,3,0,100,3.3,5077,70
sesame_street_presents_follow_that_bird,6.1,11,10,1,90,0,1,1,0,100,3.4,1485,64
were_back_a_dinosaurs_story,4,11,3,8,27,0,4,1,3,25,3.1,2567,54
baby_secret_of_the_lost_legend,3.5,9,1,8,11,0,1,0,1,0,2.8,986,37
turtle_diary,7.7,6,6,0,100,0,1,1,0,100,3.7,57,69
raise_the_titanic,5.2,5,3,2,60,0,1,0,1,0,3,2514,44
titanic,7.4,97,80,17,82,6.6,29,21,8,72,3.3,464576,68
1015079-night_to_remember,8.7,9,9,0,100,0,0,0,0,0,0,0,0
captain_horatio_hornblower,7.3,7,7,0,100,0,0,0,0,0,0,0,0
carriers_are_waiting,7.4,7,7,0,100,0,1,1,0,100,3.8,198,71
erin_brockovich,7.3,137,114,23,83,7.3,34,30,4,88,3.5,33256,76
final_destination,4.6,85,26,59,30,4.4,22,7,15,31,3.4,55113,75
soft_fruit,6.2,14,9,5,64,5.1,6,3,3,50,3.9,118,83
the-bear,7.2,11,10,1,90,0,2,1,1,50,3.6,2107,76
deep_impact,5.7,51,24,27,47,5.9,6,2,4,33,2.9,28624,51
1036046-mirror,9.2,6,6,0,100,0,1,1,0,100,4.4,2940,93
crimson_pirate,7.8,9,9,0,100,0,0,0,0,0,0,0,0
thelma_and_louise,7.9,44,40,4,90,8.2,9,9,0,100,3.3,16458,75
something_for_everyone,0,2,1,1,50,0,0,0,0,0,0,0,0
and_justice_for_all,6.9,19,18,1,94,0,2,2,0,100,3.5,3756,76
national_lampoons_animal_house,7.7,40,36,4,90,7.1,5,4,1,80,3.7,25149,88
shes_gotta_have_it,7,27,25,2,92,0,3,2,1,66,3.4,1428,66
school_daze,5.7,19,11,8,57,0,4,1,3,25,3.8,2379,80
do_the_right_thing,8.8,51,49,2,96,7.9,7,6,1,85,3.8,28566,86
mo_better_blues,6,32,23,9,71,4.5,8,3,5,37,0,0,0
fever_1991,6.7,7,4,3,57,0,1,1,0,100,3,220,36
coogans_bluff,6.8,10,10,0,100,0,1,1,0,100,3.2,1501,48
resurrecting_the_champ,6,116,69,47,59,5.5,30,15,15,50,3.4,18572,62
creature_comforts,7.6,12,11,1,91,0,0,0,0,0,0,0,0
death_wish,6,23,16,7,69,0,3,1,2,33,3.3,4245,68
death_wish,6,23,16,7,69,0,3,1,2,33,3.3,4245,68
death_wish_3,2.2,14,0,14,0,0,3,0,3,0,3.1,2045,54
death_wish_4_the_crackdown,3.8,6,1,5,16,0,0,0,0,0,0,0,0
double_indemnity,8.7,43,42,1,97,7.3,5,4,1,80,4.2,8526,93
dying_young,4.5,16,5,11,31,0,2,0,2,0,3.2,5112,66
cool_as_ice,2.2,13,1,12,7,0,2,0,2,0,0,0,0
teenage_mutant_ninja_turtles_the_movie,4.9,37,17,20,45,5.8,7,4,3,57,3.3,21473,76
teenage_mutant_ninja_turtles_2_the_secret_of_the_ooze,4.6,27,10,17,37,5.1,8,4,4,50,3.1,14179,68
teenage_mutant_ninja_turtles_iii,3.8,21,6,15,28,0,4,2,2,50,2.7,11304,42
1017321-red_dawn,4.8,16,8,8,50,0,0,0,0,0,0,0,0
band_of_the_hand,3.5,7,1,6,14,0,1,0,1,0,3.2,921,49
born_american,0,1,0,1,0,0,0,0,0,0,0,0,0
bloodsport,4.3,18,6,12,33,0,0,0,0,0,0,0,0
eyes_of_laura_mars,5.2,17,8,9,47,0,1,0,1,0,3.1,982,44
funny_bones,6.5,17,11,6,64,0,2,1,1,50,3.4,706,72
good_earth,7.4,13,12,1,92,0,3,2,1,66,3.7,367,76
good_morning_vietnam,7.3,31,28,3,90,0,1,1,0,100,3.5,13673,78
good_mother,5.5,6,4,2,66,0,1,0,1,0,3.1,241,35
grumpy_old_men,5.9,36,24,12,66,7,6,5,1,83,3.2,10489,66
guess_whos_coming_to_dinner,6,24,15,9,62,0,4,3,1,75,3.7,6951,84
romeo_must_die,4.9,89,29,60,32,5.6,20,10,10,50,3.1,16660,67
here_on_earth,3.8,67,12,55,17,3.3,23,2,21,8,3.1,3503,63
1095414-whatever_it_takes,3.5,64,10,54,15,3.6,22,3,19,13,2.9,8374,52
buddy_boy,6.2,7,5,2,71,0,2,1,1,50,3.1,563,53
color_of_paradise,7.6,31,27,4,87,8.9,5,5,0,100,4.3,1466,94
waking_the_dead,5.9,54,28,26,51,5.5,12,4,8,33,3.7,1126,77
1002597-blood_and_sand,7,8,8,0,100,0,0,0,0,0,0,0,0
gothic,5.9,11,6,5,54,0,0,0,0,0,0,0,0
1028568-lord_of_the_flies,6.4,18,11,7,61,0,1,0,1,0,3.1,6608,54
modern_times,8.9,47,47,0,100,8.2,11,11,0,100,4.2,9563,95
1105075-last_resort,7.3,70,66,4,94,7.5,23,23,0,100,3.7,459,77
solar_crisis,0,4,0,4,0,0,0,0,0,0,0,0,0
thats_life,5.7,13,6,7,46,0,1,0,1,0,3.5,371,64
heart_and_souls,5.4,22,12,10,54,0,2,1,1,50,3.4,3529,72
1010174-hud,7.2,24,19,5,79,0,3,1,2,33,3.9,2075,87
hustler,8.6,33,32,1,96,7.6,6,5,1,83,3.9,6593,90
1010555-inherit_the_wind,7.8,21,19,2,90,0,1,0,1,0,4,3071,88
dersu_uzala,7.5,12,9,3,75,0,1,0,1,0,4.3,2637,94
close_encounters_of_the_third_kind,8.6,39,37,2,94,9,5,5,0,100,3.6,21572,79
horror_hotel,0,4,2,2,50,0,0,0,0,0,0,0,0
jonah_who_will_be_25_in_the_year_2000,0,2,2,0,100,0,0,0,0,0,0,0,0
retroactive,4.4,5,2,3,40,0,0,0,0,0,0,0,0
place_in_the_sun,6.8,20,15,5,75,0,2,0,2,0,3.9,2248,86
jacobs_ladder,6.6,45,32,13,71,5,7,3,4,42,3.7,15733,82
empire_records,4.3,21,5,16,23,0,3,1,2,33,3.5,27733,83
la_bamba,6.8,20,19,1,95,0,1,1,0,100,3.2,5593,74
ladyhawke,5.5,19,12,7,63,0,0,0,0,0,0,0,0
lucas,6.2,14,9,5,64,0,2,2,0,100,3.3,2546,66
1095420-high_fidelity,7.6,145,133,12,91,7.2,38,33,5,86,3.7,41116,88
road_to_el_dorado,5.5,101,49,52,48,5.1,26,10,16,38,3.1,9172,64
skulls,3.1,84,7,77,8,3,28,2,26,7,2.8,6706,48
1001362-autopsy,0,2,1,1,50,0,0,0,0,0,0,0,0
devil_girl_from_mars,0,0,0,0,0,0,0,0,0,0,0,0,0
road_to_el_dorado,5.5,101,49,52,48,5.1,26,10,16,38,3.1,9172,64
hook,4.3,37,9,28,24,4.6,6,2,4,33,3.3,59655,72
horror-express,6,5,2,3,40,0,0,0,0,0,0,0,0
my_chauffeur,0,1,0,1,0,0,0,0,0,0,0,0,0
son_of_the_sheik,6.8,6,4,2,66,0,0,0,0,0,0,0,0
true_grit,7.6,15,14,1,93,0,1,1,0,100,3.8,4651,83
roadside_prophets,6.7,6,5,1,83,0,0,0,0,0,0,0,0
madame_sousatzka,6.2,16,12,4,75,0,4,4,0,100,3.5,120,57
midnight_express,7.7,20,19,1,95,0,0,0,0,0,0,0,0
misery,7.3,51,46,5,90,6.4,7,5,2,71,3.6,18885,83
crystal_hunt,0,0,0,0,0,0,0,0,0,0,0,0,0
murphys_romance,6.6,14,12,2,85,0,1,1,0,100,3.4,940,71
love-my-life,0,0,0,0,0,0,0,0,0,0,0,0,0
solyaris,8.3,39,38,1,97,8.2,8,8,0,100,4.1,7425,89
network,8.1,41,37,4,90,7.4,5,4,1,80,4.1,8716,93
1015218-no_way_out,7.1,27,27,0,100,8,6,6,0,100,3.3,4406,65
north_dallas_forty,6.6,20,17,3,85,0,4,4,0,100,3.4,594,69
1015380-odd_couple,8.2,31,31,0,100,0,4,4,0,100,0,0,0
outlaw_josey_wales,8,31,30,1,96,0,3,2,1,66,0,0,0
1090027-black_and_white,4.3,8,2,6,25,0,0,0,0,0,0,0,0
frequency,6.5,122,85,37,69,6.4,27,20,7,74,3.4,17214,78
ready_to_rumble,4,64,16,48,25,4.3,15,4,11,26,2.6,3493,49
return_to_me,6.1,97,59,38,60,5.5,26,14,12,53,3.3,8306,76
rules_of_engagement,5,93,34,59,36,5,24,9,15,37,3.2,7074,60
joe_goulds_secret,6.6,31,20,11,64,7.3,7,5,2,71,3.4,281,59
me_myself_and_irene,5.4,95,46,49,48,4.7,24,9,15,37,3.1,39953,60
bell_book_and_candle,5.8,9,6,3,66,0,0,0,0,0,0,0,0
end_of_violence,4.8,33,9,24,27,4.6,10,1,9,10,3,659,43
force_10_from_navarone,6.1,11,7,4,63,0,1,0,1,0,3.3,2137,56
how_to_stuff_a_wild_bikini,0,2,0,2,0,0,0,0,0,0,0,0,0
1028711-mystery_train,7.2,25,21,4,84,0,1,1,0,100,3.9,3307,87
1018051-sacco_and_vanzetti,5.9,6,3,3,50,0,4,2,2,50,4,58,94
taffin,0,2,0,2,0,0,0,0,0,0,0,0,0
1133964-king_arthur,4.9,183,57,126,31,5.2,38,12,26,31,3.2,57867,63
1001526-bachelor_party,5.4,20,11,9,55,0,1,1,0,100,3,5525,53
parenthood,7.2,39,36,3,92,7.9,7,7,0,100,3.2,6310,68
predator,6.8,37,28,9,75,0,4,2,2,50,3.5,52908,83
prince_of_tides,6.4,19,14,5,73,0,2,1,1,50,3.3,2156,68
1016592-postman_always_rings_twice,6.3,10,7,3,70,0,1,0,1,0,3.3,2610,61
all_the_vermeers_in_new_york,7.2,5,5,0,100,0,1,1,0,100,3,232,49
actors_revenge,7.5,9,8,1,88,0,2,2,0,100,4.2,181,88
28_days_later,7.3,200,177,23,88,7.1,39,34,5,87,3.6,107149,82
american_psycho,6.3,122,81,41,66,5.8,28,16,12,57,3.6,57904,83
keeping_the_faith,6.2,114,78,36,68,5.8,25,14,11,56,3,9636,55
where_the_money_is,5.3,74,34,40,45,5.6,19,10,9,52,3,517,36
east_is_east,7.2,30,24,6,80,7.1,6,5,1,83,3.6,2798,75
filth_and_the_fury,7.8,37,35,2,94,8.6,6,6,0,100,4,362,82
passion_of_mind,3.9,33,5,28,15,3.8,7,0,7,0,3.1,711,45
third_world_cop,4.6,12,2,10,16,0,4,0,4,0,3.8,477,77
coming_apart,0,4,2,2,50,0,0,0,0,0,0,0,0
diner,8.2,25,24,1,96,0,2,2,0,100,3.6,2408,75
shakes_the_clown,4.4,19,7,12,36,0,2,0,2,0,0,0,0
cabaret,8.3,32,31,1,96,6.6,5,4,1,80,3.8,7394,86
what-ever-happened-to-baby-jane,7.6,37,33,4,89,0,3,2,1,66,3.9,7128,89
prick_up_your_ears,7.6,15,15,0,100,0,1,1,0,100,3.7,1024,76
auntie_mame,8,13,12,1,92,0,0,0,0,0,0,0,0
guys_and_dolls,6.9,15,12,3,80,0,0,0,0,0,0,0,0
1200841-hunger,7.7,109,98,11,89,7.5,24,21,3,87,3.5,21784,75
marathon_man,7.2,34,27,7,79,0,1,1,0,100,3.6,4534,81
caddyshack,6.5,44,33,11,75,0,4,1,3,25,3.6,26005,86
gossip,4.4,65,18,47,27,3.8,19,4,15,21,2.9,3212,45
love_and_basketball,6.7,86,70,16,81,6.7,29,24,5,82,3.9,41056,93
u571,6.2,94,64,30,68,5.9,26,16,10,61,3.1,8932,60
virgin_suicides,7,90,70,20,77,7.5,17,16,1,94,3.5,29052,80
jennifer_8,5.2,16,7,9,43,0,2,0,2,0,2.9,1225,39
limelight,7.7,13,13,0,100,0,0,0,0,0,0,0,0
empire-of-passion-ai-no-borei,0,2,1,1,50,0,0,0,0,0,0,0,0
1096844-committed,5.4,38,17,21,44,5.2,10,5,5,50,2.7,930,32
crow_salvation,4.6,9,2,7,22,0,1,1,0,100,2.9,8151,53
flintstones_in_viva_rock_vegas,4,70,17,53,24,4.5,20,6,14,30,2.3,3581,30
1096832-where_the_heart_is,4.6,94,32,62,34,3.9,27,5,22,18,3.5,12595,78
big_kahuna,6.4,76,56,20,73,6.4,22,15,7,68,3.3,1772,65
bossa_nova,6.6,28,21,7,75,0,4,2,2,50,3.2,470,54
smiling_fish_and_goat_on_fire,5.8,14,7,7,50,0,4,2,2,50,3.2,55,50
last_september,5.5,23,9,14,39,7.1,5,4,1,80,3,278,39
timecode,6.3,80,54,26,67,6.4,21,14,7,66,3,896,50
carnosaur,3.2,9,1,8,11,0,0,0,0,0,0,0,0
carnosaur_2,0,2,0,2,0,0,0,0,0,0,0,0,0
carnosaur_3_primal_species,0,2,0,2,0,0,0,0,0,0,0,0,0
1091727-defying_gravity,5.9,6,4,2,66,0,3,2,1,66,3.5,284,57
1153493-cache,7.8,128,113,15,88,8.2,31,29,2,93,3.5,16387,71
two_moon_junction,3.2,6,0,6,0,0,1,0,1,0,3.1,1343,54
gladiator,7,159,123,36,77,6.4,36,26,10,72,3.8,248672,85
up_at_the_villa,5.3,58,27,31,46,4.9,19,7,12,36,3,371,34
human_traffic,6.1,28,17,11,60,5.5,7,2,5,28,4,6954,88
black-tights-1234-ou-les-collants-noirs,0,0,0,0,0,0,0,0,0,0,0,0,0
breathless,8.6,48,46,2,95,8.1,12,11,1,91,4.2,10327,90
great_locomotive_chase,0,2,1,1,50,0,0,0,0,0,0,0,0
idolmaker,6.4,7,6,1,85,0,1,1,0,100,3.7,186,80
from_dusk_till_dawn,6,43,27,16,62,4.9,10,5,5,50,3.4,36073,75
king_of_marvin_gardens,6.4,17,12,5,70,0,4,2,2,50,3.3,626,55
die-nibelungen-teil-1-siegfried-whom-the-gods-wish-to-destroy,0,0,0,0,0,0,0,0,0,0,0,0,0
lords_of_flatbush,5.6,11,7,4,63,0,3,0,3,0,3.1,800,43
mr_mom,5.9,17,13,4,76,0,1,0,1,0,3,3176,54
time-masters-les-maitres-du-temps,0,1,0,1,0,0,0,0,0,0,0,0,0
battlefield_earth,2.3,122,3,119,2,2.4,29,1,28,3,1.6,6896,14
center_stage,5,79,33,46,41,5.2,21,9,12,42,3.5,28939,79
held_up,3.3,30,5,25,16,3,8,1,7,12,2.9,580,48
1097242-screwed,3.5,30,4,26,13,2.7,5,1,4,20,2.9,1198,48
whipped,3.2,68,9,59,13,2.9,23,3,20,13,2.4,782,32
1075422-hamlet,8.2,54,51,3,94,7.2,14,11,3,78,3.8,5816,86
anchors_aweigh,7.2,5,3,2,60,0,0,0,0,0,0,0,0
blue_hawaii,4.3,6,1,5,16,0,0,0,0,0,0,0,0
castaway_cowboy,0,2,1,1,50,0,0,0,0,0,0,0,0
gi_blues,4.7,5,0,5,0,0,0,0,0,0,0,0,0
gay_deceivers,0,3,0,3,0,0,0,0,0,0,0,0,0
1009076-gypsy,6.4,11,8,3,72,0,0,0,0,0,0,0,0
king_creole,6.7,12,12,0,100,0,0,0,0,0,0,0,0
1015542-on_the_town,8,16,15,1,93,0,0,0,0,0,0,0,0
one_little_indian,0,0,0,0,0,0,0,0,0,0,0,0,0
peewees_big_adventure,7.4,35,32,3,91,0,4,1,3,25,3,14034,66
regret-to-inform,7.7,16,15,1,93,0,3,3,0,100,3.7,139,55
roustabout,5.7,8,5,3,62,0,0,0,0,0,0,0,0
slipper_and_the_rose,0,1,1,0,100,0,0,0,0,0,0,0,0
things_change,6.9,11,9,2,81,0,1,1,0,100,3.5,240,70
honeymoon_in_vegas,6,26,17,9,65,0,2,1,1,50,2.7,3153,35
1097046-dinosaur,6.2,120,78,42,65,6,30,20,10,66,3,9615,48
1098734-loser,4.2,94,23,71,24,4.5,26,9,17,34,2.6,5745,37
1097259-road_trip,5.9,89,52,37,58,5.9,21,14,7,66,3.3,57286,68
small_time_crooks,6.4,98,65,33,66,6.2,22,13,9,59,3.2,3828,54
hollywood_knights,0,4,1,3,25,0,0,0,0,0,0,0,0
myth_of_fingerprints,6,19,12,7,63,0,3,1,2,33,3.2,418,54
10009228-possession,0,2,0,2,0,0,1,0,1,0,2.9,4231,34
1022170-twelve_chairs,6.5,13,12,1,92,0,0,0,0,0,0,0,0
mission_impossible,5.8,45,26,19,57,5.2,18,9,9,50,3.3,46104,70
shanghai_noon,6.6,130,102,28,78,5.9,28,18,10,64,3.2,29911,67
better_living_through_circuitry,6.4,16,13,3,81,0,4,3,1,75,0,0,0
8_12_women,4.9,35,14,21,40,5.2,7,2,5,28,3.1,1362,51
1003612-carnival_of_souls,7.2,31,25,6,80,0,4,3,1,75,3.5,2508,71
1007615-flying_tigers,5.9,8,5,3,62,0,0,0,0,0,0,0,0
the-gold-rush,8.8,30,30,0,100,0,4,4,0,100,4.1,4794,91
its_in_the_water,0,3,1,2,33,0,0,0,0,0,0,0,0
monsieur_verdoux,8,24,23,1,95,6.8,5,4,1,80,4,1388,88
on_her_majestys_secret_service,6.6,37,30,7,81,6.2,5,3,2,60,3.2,8953,62
seven_days_in_may,7.8,18,18,0,100,0,3,3,0,100,3.9,754,86
spy_who_loved_me,6.7,37,29,8,78,5.2,5,2,3,40,3.4,10473,71
those_who_love_me_can_take_the_train,5.7,17,10,7,58,0,2,2,0,100,3.6,478,68
vagabond,8.6,11,11,0,100,0,1,1,0,100,4,549,82
1014217-moonraker,5.7,36,23,13,63,7.6,6,6,0,100,3,10343,48
man_with_the_golden_gun,5.1,33,17,16,51,3.6,5,0,5,0,3.3,11297,63
king_of_new_york,6,23,16,7,69,6.2,5,3,2,60,3.7,5329,77
in_old_california,0,0,0,0,0,0,0,0,0,0,0,0,0
fighting_seabees,6.8,5,5,0,100,0,0,0,0,0,0,0,0
dark_command,0,4,4,0,100,0,0,0,0,0,0,0,0
cleo_de_5_a_7,8.6,21,20,1,95,0,2,1,1,50,4,1372,88
big_mommas_house,4.4,80,24,56,30,4.2,26,9,17,34,3.2,47401,68
the-abominable-snowman,0,0,0,0,0,0,0,0,0,0,0,0,0
american_gigolo,6.4,15,11,4,73,0,1,1,0,100,3.1,2098,49
anguish,0,3,1,2,33,0,0,0,0,0,0,0,0
blood_spattered_bride,7.2,6,6,0,100,0,0,0,0,0,0,0,0
city_of_the_living_dead,4.9,10,5,5,50,0,0,0,0,0,0,0,0
endless_summer,7.2,15,15,0,100,0,3,3,0,100,4.1,1286,88
guns_of_navarone,8,20,19,1,95,0,0,0,0,0,0,0,0
grande_bouffe,0,3,2,1,66,0,1,0,1,0,4,1017,85
lured,0,3,3,0,100,0,0,0,0,0,0,0,0
quatermass_and_the_pit,7.2,8,6,2,75,0,2,0,2,0,3.7,842,75
quatermass_ii,6.3,8,6,2,75,0,1,0,1,0,0,0,0
puppet_master,3.4,5,1,4,20,0,0,0,0,0,0,0,0
puppet_master_2_his_unholy_creations,4.4,5,1,4,20,0,0,0,0,0,0,0,0
puppet_master_3_toulons_revenge,0,2,1,1,50,0,0,0,0,0,0,0,0
puppet-master-iv,3.6,5,0,5,0,0,0,0,0,0,0,0,0
puppet_master_5_the_final_chapter,0,2,0,2,0,0,0,0,0,0,0,0,0
curse_of_the_puppet_master,0,2,0,2,0,0,0,0,0,0,0,0,0
puppet_master_the_legacy,0,0,0,0,0,0,0,0,0,0,0,0,0
rentacop,3.8,11,2,9,18,0,1,0,1,0,2.3,601,19
1102360-romeo_and_juliet,0,0,0,0,0,0,0,0,0,0,0,0,0
stay_tuned,4.8,12,6,6,50,0,0,0,0,0,0,0,0
1095636-story_of_gi_joe,5.9,10,7,3,70,0,2,0,2,0,3.5,303,71
blazing_saddles,8.1,45,40,5,88,7.5,5,4,1,80,3.9,41980,89
benji_the_hunted,5.6,7,4,3,57,0,0,0,0,0,0,0,0
benji_the_hunted,5.6,7,4,3,57,0,0,0,0,0,0,0,0
for_the_love_of_benji,0,0,0,0,0,0,0,0,0,0,0,0,0
1023543-white_christmas,6.4,30,23,7,76,0,3,1,2,33,0,0,0
eraserhead,7.9,40,36,4,90,6.5,5,4,1,80,3.9,15996,83
boys_of_baraka,6.8,42,31,11,73,6.8,13,10,3,76,4,627,84
man_with_the_golden_arm,6.9,17,14,3,82,0,3,1,2,33,3.8,961,84
decline_of_western_civilization_iii,7.6,7,7,0,100,0,2,2,0,100,4,242,78
decline_of_western_civilization_pt_2_the_the_metal_years,6.4,5,4,1,80,0,2,1,1,50,3.9,762,80
for_a_few_dollars_more,7.8,24,22,2,91,0,2,1,1,50,3.9,15319,91
magnum_force,6.6,20,16,4,80,0,0,0,0,0,0,0,0
blood_simple,8.1,77,73,4,94,7.9,12,11,1,91,3.9,11335,86
fabulous_baker_boys,7.4,23,22,1,95,8.2,5,5,0,100,3.2,2272,59
prizzis_honor,7,32,28,4,87,0,3,2,1,66,3.3,2048,61
flatliners,5.3,23,12,11,52,0,2,1,1,50,3.2,10417,61
gandahar-light-years,0,0,0,0,0,0,0,0,0,0,0,0,0
1016561-porkys,4.5,22,7,15,31,0,1,0,1,0,3.1,8737,58
porkys_ii_the_next_day,3.6,9,1,8,11,0,0,0,0,0,0,0,0
porkys_revenge,3.7,11,3,8,27,0,0,0,0,0,0,0,0
1016805-private_school,0,1,0,1,0,0,0,0,0,0,0,0,0
class_of_nuke_em_high,4.2,5,1,4,20,0,0,0,0,0,0,0,0
toxic_avenger,5.4,16,10,6,62,0,3,3,0,100,3.1,5107,60
the-toxic-avenger-part-ii,2.7,8,0,8,0,0,0,0,0,0,0,0,0
toxic_avenger_the_pt_3_the_last_temptation_of_toxie,0,1,0,1,0,0,0,0,0,0,0,0,0
night_of_the_creeps,6.7,11,8,3,72,0,0,0,0,0,0,0,0
predator,6.8,37,28,9,75,0,4,2,2,50,3.5,52908,83
running_man,5.5,32,20,12,62,5,5,2,3,40,3.2,13632,59
starman,6.5,23,18,5,78,0,4,2,2,50,3.2,5773,61
brother_from_another_planet,7.1,24,22,2,91,0,4,2,2,50,3.5,941,74
mad_max,7.7,38,36,2,94,6.4,5,4,1,80,3.4,17975,69
road_warrior,8.3,36,36,0,100,7.8,6,6,0,100,3.5,18318,76
mad_max_beyond_thunderdome,6.3,37,30,7,81,6.7,7,6,1,85,3.1,11185,50
bird_on_a_wire,4.4,20,6,14,30,0,2,0,2,0,2.8,6723,43
1000959-angel_heart,7.1,20,15,5,75,0,2,2,0,100,3.6,7026,79
9_12_weeks,5.5,21,13,8,61,0,1,1,0,100,3,6256,57
firestarter,5,21,8,13,38,0,1,0,1,0,3.1,7166,57
sleepwalking,4.2,57,10,47,17,4.3,22,4,18,18,3,8038,45
action_jackson,3.2,10,1,9,10,0,1,0,1,0,2.6,2187,30
sarafina,5.1,8,4,4,50,0,1,0,1,0,3.8,1077,83
soapdish,6,33,24,9,72,5.8,8,5,3,62,3.1,2023,56
1031744-long_walk_home,6.7,12,10,2,83,0,2,2,0,100,3.6,831,78
claras_heart,5.2,8,3,5,37,0,1,0,1,0,3.5,408,69
1003276-burglar,4,11,3,8,27,0,1,0,1,0,2.7,844,43
fatal_beauty,3.5,12,3,9,25,0,4,1,3,25,2.8,1052,40
1097865-gone_in_60_seconds,4.4,133,32,101,24,4,35,8,27,22,3.5,92563,79
1097930-american_pimp,6,21,11,10,52,0,4,1,3,25,3.5,767,67
loves_labours_lost,5.6,61,30,31,49,4.7,17,6,11,35,3.1,949,46
ignite_2007,0,0,0,0,0,0,0,0,0,0,0,0,0
trixie,4.2,48,13,35,27,3.4,14,2,12,14,2.8,268,30
last_american_virgin,5.8,9,6,3,66,0,1,0,1,0,3.3,3330,60
1075422-hamlet,8.2,54,51,3,94,7.2,14,11,3,78,3.8,5816,86
1004559-coming_home,7.4,21,17,4,80,0,4,2,2,50,3.7,1137,79
american_pop,5.6,16,9,7,56,0,0,0,0,0,0,0,0
assault_on_precinct_13,5.9,160,96,64,60,6,36,23,13,63,3.1,12635,54
1014793-near_dark,7.4,41,37,4,90,6.9,6,5,1,83,3.5,5751,73
one_false_move,8.5,26,26,0,100,0,2,2,0,100,3.5,963,67
1018699-shaft,7.4,31,28,3,90,0,2,1,1,50,3.3,2211,66
conversation,8.6,43,42,1,97,0,4,4,0,100,4,7644,89
cutters_way,7.3,5,5,0,100,0,0,0,0,0,0,0,0
balls_of_fury,4.2,127,29,98,22,4.5,24,8,16,33,2.8,85682,36
paper_chase,7.3,24,21,3,87,0,4,3,1,75,3.5,842,72
prince_of_the_city,7.3,16,15,1,93,0,1,1,0,100,3.9,431,82
serpico,8,37,34,3,91,0,4,4,0,100,3.8,14881,85
1107426-ace_in_the_hole,7.9,22,19,3,86,0,4,2,2,50,4.2,1846,92
lonely_are_the_brave,8.4,10,9,1,90,0,0,0,0,0,0,0,0
sugarland_express,7.2,25,23,2,92,0,2,1,1,50,3.3,1677,60
1118325-trouble_in_paradise,8.4,22,20,2,90,7.6,8,7,1,87,4.2,1059,91
his-big-white-self,0,0,0,0,0,0,0,0,0,0,0,0,0
1001577-badlands,8.7,38,37,1,97,0,4,4,0,100,0,0,0
battleship_potemkin,9,30,30,0,100,0,3,3,0,100,4,4546,85
boys_and_girls,3.8,61,7,54,11,3.9,20,3,17,15,2.8,3763,51
1018699-shaft,7.4,31,28,3,90,0,2,1,1,50,3.3,2211,66
titan_ae,5.7,97,49,48,50,5.9,27,15,12,55,3.2,13747,59
la-lengua-de-las-mariposas-butterfly-butterfly-tongues,7.3,24,23,1,95,7.8,5,5,0,100,4.1,1520,89
jesus_son,7.3,43,35,8,81,7.6,9,7,2,77,3.8,1524,83
match_point,7.2,205,158,47,77,7.9,40,36,4,90,3.4,41276,78
time_regained,7,25,17,8,68,0,3,3,0,100,3.6,451,71
chicken_run,8,139,134,5,96,7.9,31,31,0,100,3,41786,53
me_myself_and_irene,5.4,95,46,49,48,4.7,24,9,15,37,3.1,39953,60
1098149-patriot,6.1,131,81,50,61,5.2,30,14,16,46,3.6,80249,80
adventures_of_rocky_and_bullwinkle,4.8,92,39,53,42,5.2,26,13,13,50,2.2,4613,24
big-boats-busy-harbors,0,0,0,0,0,0,0,0,0,0,0,0,0
golden_bowl,5.3,85,45,40,52,5.6,27,15,12,55,3,832,38
10009261-asylum,0,2,0,2,0,0,1,0,1,0,2.2,1071,17
alice_sweet_alice,0,3,2,1,66,0,0,0,0,0,0,0,0
fun_and_fancy_free,5.9,6,4,2,66,0,2,1,1,50,3.4,1979,62
kentucky_fried_movie,6.6,26,20,6,76,0,3,2,1,66,3.5,2991,67
blood_in_blood_out,5.4,10,5,5,50,0,3,1,2,33,4.1,9658,92
fx2_the_deadly_art_of_illusion,4.6,12,3,9,25,0,2,0,2,0,2.8,1000,37
fx2_the_deadly_art_of_illusion,4.6,12,3,9,25,0,2,0,2,0,2.8,1000,37
hottest-mailcom,0,0,0,0,0,0,0,0,0,0,0,0,0
missing_in_action_2_the_beginning,0,0,0,0,0,0,0,0,0,0,0,0,0
missing_in_action_2_the_beginning,0,0,0,0,0,0,0,0,0,0,0,0,0
braddock_missing_in_action_3,0,0,0,0,0,0,0,0,0,0,0,0,0
thunderbolt_and_lightfoot,6.6,22,19,3,86,0,3,2,1,66,3.5,1983,69
dreamscape,6.4,27,21,6,77,0,3,1,2,33,3.1,2088,48
golden_voyage_of_sinbad,5.4,7,4,3,57,0,0,0,0,0,0,0,0
house_party,6.8,22,21,1,95,7.5,6,6,0,100,2.9,3949,74
house_party_2,4.4,12,3,9,25,0,2,0,2,0,2.8,2457,59
make_mine_music,6.3,9,6,3,66,0,3,1,2,33,3.1,777,46
melody_time,7.3,8,7,1,87,0,2,2,0,100,3.2,896,48
nekromantik_1987,4.7,6,3,3,50,0,0,0,0,0,0,0,0
project-moonbase,0,1,0,1,0,0,0,0,0,0,0,0,0
rocketship_xm,0,1,1,0,100,0,0,0,0,0,0,0,0
shaft_in_africa,4.9,7,3,4,42,0,0,0,0,0,0,0,0
shafts_big_score,5.6,10,7,3,70,0,1,1,0,100,0,0,0
croupier,7.7,53,52,1,98,7.7,13,13,0,100,3.6,2486,76
karate_kid,6.9,41,37,4,90,6.9,5,4,1,80,3.3,20688,71
scary_movie,5.5,109,58,51,53,5.1,28,14,14,50,3,178002,50
but_im_a_cheerleader,4.7,46,15,31,32,4.1,12,3,9,25,3.4,7077,74
shower,7.3,29,25,4,86,6.6,5,3,2,60,3.9,957,89
1002673-blowup,8,35,30,5,85,7.5,5,4,1,80,4,7433,86
pawnbroker,8.4,6,6,0,100,0,0,0,0,0,0,0,0
groove,6.1,50,28,22,56,5.5,14,6,8,42,3.8,1177,79
1007657-footloose,5.6,32,18,14,56,0,4,3,1,75,3.3,28933,73
duel_in_the_sun,6.5,14,12,2,85,0,0,0,0,0,0,0,0
xmen,7,152,124,28,81,5.8,32,19,13,59,3.7,133573,83
chuck_and_buck,7,85,72,13,84,7,31,26,5,83,3.2,907,59
five_senses,6.7,31,23,8,74,6.3,7,4,3,57,3.6,461,76
immortality,5.3,19,9,10,47,6.3,5,4,1,80,3.2,1130,51
1098652-in_crowd,2.7,52,1,51,1,2.4,14,0,14,0,2.6,925,41
what_lies_beneath,5.5,122,55,67,45,5.1,30,13,17,43,3.1,17841,61
pokemon_the_movie_2000,3.8,63,10,53,15,4,18,4,14,22,2.7,8481,51
criminal_lovers,6.1,14,9,5,64,0,2,1,1,50,3.4,502,63
anatomy-of-a-murder,8.5,35,35,0,100,0,4,4,0,100,4,3171,89
freejack,4.1,12,2,10,16,0,1,0,1,0,2.6,3020,27
greasers_palace,4,5,2,3,40,0,1,0,1,0,3.7,274,72
some_like_it_hot,8.9,40,39,1,97,0,4,4,0,100,4.1,23119,93
knight_rider,0,0,0,0,0,0,0,0,0,0,0,0,0
mackennas_gold,5.4,5,2,3,40,0,0,0,0,0,0,0,0
sinbad_and_the_eye_of_the_tiger,6,8,5,3,62,0,0,0,0,0,0,0,0
1022238-two_women,8.6,7,7,0,100,0,0,0,0,0,0,0,0
what_about_bob,6.4,38,31,7,81,6.9,7,6,1,85,3.3,13746,74
white_sands,5,13,6,7,46,0,1,0,1,0,2.9,802,36
breaker_morant,8.4,20,20,0,100,0,0,0,0,0,0,0,0
everything_you_always_wanted_to_know_about_sex_but_were_afraid_to_ask,7.3,19,17,2,89,0,0,0,0,0,0,0,0
interiors,6.5,12,9,3,75,0,0,0,0,0,0,0,0
love_and_death,8,15,15,0,100,0,1,1,0,100,4,4797,88
official_story,8.3,8,8,0,100,0,1,1,0,100,3.9,624,86
other_side_of_sunday,0,3,2,1,66,0,0,0,0,0,0,0,0
pot_o_gold,0,2,1,1,50,0,0,0,0,0,0,0,0
tampopo,8.3,13,13,0,100,0,1,1,0,100,4.3,2542,93
thomas_and_the_magic_railroad,3.9,65,12,53,18,4.3,19,5,14,26,2.8,700,41
nutty_professor_ii_the_klumps,4.4,84,22,62,26,4.8,22,8,14,36,2.7,14847,53
girl_on_the_bridge,7.4,39,35,4,89,7.4,7,6,1,85,4.1,2378,88
wonderland,5,98,34,64,34,4.5,32,7,25,21,3.3,3666,67
autumn_in_new_york,4.1,68,14,54,20,3.6,19,3,16,15,3,6655,56
coyote_ugly,3.9,94,20,74,21,3.6,27,5,22,18,3.2,65988,73
hollow_man,4.4,112,31,81,27,3.8,29,5,24,17,2.6,18221,35
space_cowboys,6.8,114,90,24,78,7,28,23,5,82,3,9433,49
mad_about_mambo,5.2,14,8,6,57,0,4,1,3,25,3.1,674,46
psycho_beach_party,5.5,31,17,14,54,4.4,7,2,5,28,3.3,1978,62
black_sabbath,6.7,12,10,2,83,0,0,0,0,0,0,0,0
brain-that-wouldnt-die,4.2,11,4,7,36,0,0,0,0,0,0,0,0
bronco_billy,6.5,15,12,3,80,0,0,0,0,0,0,0,0
kellys_heroes,7,14,12,2,85,0,0,0,0,0,0,0,0
phantasm_2,3.9,14,4,10,28,0,1,0,1,0,0,0,0
phantasm_iii_lord_of_the_dead,4.5,9,4,5,44,0,0,0,0,0,0,0,0
phantasm_iv_oblivion,3.5,7,1,6,14,0,0,0,0,0,0,0,0
pumpkinhead,5.3,16,9,7,56,0,1,0,1,0,2.9,3312,52
air_america,3.4,14,2,12,14,0,1,0,1,0,2.7,5347,37
sleepaway_camp,6.2,10,7,3,70,0,0,0,0,0,0,0,0
steel_magnolias,5.8,18,12,6,66,0,1,1,0,100,3.6,26167,88
1000914-and_god_created_woman,6.2,11,8,3,72,0,1,0,1,0,3,1435,52
1006425-easy_money,5.2,6,2,4,33,0,1,0,1,0,3.1,883,57
ilsa_she_wolf_of_the_ss,3.9,10,3,7,30,0,1,0,1,0,3,950,49
silent_fall,4.1,17,4,13,23,3.2,5,0,5,0,3,420,37
1019625-spiral_staircase,8,13,12,1,92,0,0,0,0,0,0,0,0
whatever-happened-to-aunt-alice,0,0,0,0,0,0,0,0,0,0,0,0,0
im_the_one_that_i_want,6.7,22,13,9,59,0,4,2,2,50,0,0,0
tao_of_steve,6.8,47,37,10,78,7.8,9,9,0,100,3.4,1245,66
the-tic-code,6.6,28,21,7,75,7.2,11,10,1,90,3.5,135,64
aimee-and-jaguar,7.2,48,43,5,89,7.1,13,12,1,92,4,1140,84
affair_of_love,7.4,34,29,5,85,8.6,7,7,0,100,3.7,724,75
bless_the_child,2.9,97,3,94,3,2.4,28,0,28,0,2.8,4085,45
cecil_b_demented,5.6,78,40,38,51,4.4,24,8,16,33,3.4,2682,65
eyes_of_tammy_faye,7,34,29,5,85,7.6,6,6,0,100,3.6,398,69
opportunists,5.7,26,14,12,53,6.9,6,5,1,83,3.1,74,41
replacements,4.9,105,42,63,40,4.5,32,11,21,34,3.1,15029,70
about_adam,6,57,39,18,68,6.7,16,13,3,81,3,2040,45
cell,5.3,142,65,77,45,4.5,31,13,18,41,2.8,13598,55
cnn-millennium-20002000,0,0,0,0,0,0,0,0,0,0,0,0,0
original_kings_of_comedy,6.9,87,75,12,86,7.1,29,26,3,89,3.7,3266,81
sunset_boulevard,9.2,52,51,1,98,8.2,7,7,0,100,4.3,12588,95
its_the_rage,4.2,11,3,8,27,0,1,0,1,0,2.9,444,40
naked_gun_from_the_files_of_police_squad,7.2,35,31,4,88,0,4,4,0,100,3.2,16516,78
naked_gun_2_12_the_the_smell_of_fear,5.8,34,19,15,55,6.9,7,6,1,85,2.9,10932,66
1015737-our_town,7.2,7,6,1,85,0,0,0,0,0,0,0,0
shane,8.3,28,27,1,96,0,4,3,1,75,3.7,3957,78
suddenly_last_summer,7.7,6,6,0,100,0,0,0,0,0,0,0,0
cat_ballou,7.4,19,19,0,100,0,0,0,0,0,0,0,0
couch_in_new_york,0,3,1,2,33,0,0,0,0,0,0,0,0
devil_rides_out,7.3,14,13,1,92,0,2,2,0,100,3.7,898,74
tom_and_jerry_the_movie,2.8,6,1,5,16,0,0,0,0,0,0,0,0
supergirl,3.3,24,2,22,8,0,4,0,4,0,2.3,7270,28
x-the-unknown1956,0,0,0,0,0,0,0,0,0,0,0,0,0
1099604-art_of_war,3.9,80,13,67,16,3.8,25,6,19,24,2.9,3794,45
ballad_of_ramblin_jack,7.4,18,17,1,94,0,3,3,0,100,3.6,162,48
bittersweet-motel,0,1,1,0,100,0,1,1,0,100,4.3,140,92
bring_it_on,6,115,73,42,63,5.7,32,19,13,59,3.1,100795,68
catfish_in_black_bean_sauce,5.3,14,6,8,42,0,4,1,3,25,3.5,264,64
star_trek_11,8.1,281,265,16,94,7.8,41,38,3,92,4.1,380680,91
steal_this_movie,5.5,41,22,19,53,5.1,9,4,5,44,3.6,704,69
went_to_coney_island_on_a_mission_from_god_be_back_by_five,5.4,7,3,4,42,0,1,0,1,0,0,0,0
skipped_parts,0,4,1,3,25,0,0,0,0,0,0,0,0
highlander_endgame,3.3,53,6,47,11,3.6,13,2,11,15,2.8,5402,49
1204891-center_stage_turn_it_up,0,4,2,2,50,0,0,0,0,0,0,0,0
nurse_betty,7.2,129,108,21,83,6.6,33,24,9,72,2.6,4271,37
solas,7.3,19,17,2,89,7.3,5,4,1,80,4,317,87
watcher,3.4,87,9,78,10,3.3,25,2,23,8,2.7,3820,36
way_of_the_gun,5.4,102,48,54,47,4.9,24,10,14,41,3.3,5742,68
almost_famous,7.8,159,139,20,87,7.1,33,26,7,78,3.7,57797,89
1100039-bait,4.2,81,21,60,25,3.4,22,4,18,18,2.9,2354,44
1052608-circus,8.4,15,15,0,100,0,2,2,0,100,4.1,1756,92
crime_and_punishment_in_suburbia,3.6,29,6,23,20,3,12,2,10,16,3.3,634,61
1100086-duets,3.9,88,18,70,20,3.9,25,5,20,20,2.9,2253,44
goya_in_bordeaux,6,26,14,12,53,6.2,6,2,4,33,3.5,289,65
urbania,6.8,27,19,8,70,7.2,6,4,2,66,3.6,469,73
specials,5.1,15,7,8,46,0,1,0,1,0,3.3,699,59
1100197-under_suspicion,5.3,44,22,22,50,5.2,12,6,6,50,3.2,1858,49
1099709-prince_of_central_park,4.4,5,1,4,20,0,1,0,1,0,3,480,40
urban_legends_final_cut,3,78,7,71,8,2.6,20,1,19,5,2.5,5717,35
woman_on_top,4.8,95,33,62,34,4.7,28,9,19,32,3,2022,44
dancer_in_the_dark,6.7,113,76,37,67,6.2,26,17,9,65,4.1,17700,90
best_in_show,7.5,107,101,6,94,7.6,29,28,1,96,3.7,12719,87
beautiful_mind,7.1,180,140,40,77,7.2,37,30,7,81,3.9,103150,91
barenaked_in_america,6.4,18,14,4,77,6.9,5,4,1,80,0,0,0
broken_hearts_club,6,27,17,10,62,0,4,3,1,75,3.6,2111,70
remember_the_titans,6.3,130,94,36,72,5.8,32,20,12,62,3.9,91483,91
hellraiser,5.9,30,19,11,63,0,3,0,3,0,3.4,13712,77
hellbound_hellraiser_2,5.1,18,8,10,44,0,3,1,2,33,3.2,6950,68
hellraiser_iii_hell_on_earth,3.8,9,2,7,22,0,1,0,1,0,2.9,5917,52
myopic-visions,0,0,0,0,0,0,0,0,0,0,0,0,0
psycho_beach_party,5.5,31,17,14,54,4.4,7,2,5,28,3.3,1978,62
bikini_beach,0,0,0,0,0,0,0,0,0,0,0,0,0
return_of_the_fly,4.8,12,5,7,41,0,0,0,0,0,0,0,0
pajama_party,4.5,7,3,4,42,0,0,0,0,0,0,0,0
stranger_than_paradise,7.6,19,18,1,94,0,1,1,0,100,4,4419,88
voyage_to_the_bottom_of_the_sea,6.2,11,9,2,81,0,0,0,0,0,0,0,0
fantastic_voyage,7,25,23,2,92,0,3,3,0,100,3.3,1258,66
abbott_and_costello,7.1,22,20,2,90,0,2,0,2,0,3.8,2347,81
bank_dick,8.6,21,21,0,100,0,3,3,0,100,0,0,0
1004906-creature_from_the_black_lagoon,7,26,22,4,84,0,2,1,1,50,3.3,4189,63
giant_gila_monster,2.9,8,1,7,12,0,0,0,0,0,0,0,0
1010695-invisible_man,8.4,29,29,0,100,0,4,4,0,100,3.7,2484,78
killer_shrews,4.7,9,5,4,55,0,0,0,0,0,0,0,0
kronos,5,6,4,2,66,0,0,0,0,0,0,0,0
phantom_of_the_opera,5,165,54,111,32,4.6,37,10,27,27,3.7,70849,86
runaway_jury,6.6,152,111,41,73,6.6,38,28,10,73,3.4,11578,73
slumber_party_massacre,4,10,3,7,30,0,0,0,0,0,0,0,0
slumber_party_massacre_2,0,3,0,3,0,0,0,0,0,0,0,0,0
slumber_party_massacre_3,0,2,0,2,0,0,0,0,0,0,0,0,0
sorority_house_massacre,0,4,0,4,0,0,0,0,0,0,0,0,0
sorority-house-massacre-ii-night-frenzy-nighty-nightmare,0,2,1,1,50,0,0,0,0,0,0,0,0
bamboozled,5.4,96,46,50,47,5.5,32,16,16,50,3.6,2334,74
bootmen,4.9,17,6,11,35,4.4,5,1,4,20,3.4,1576,65
digimon_digital_monsters,0,3,0,3,0,0,0,0,0,0,0,0,0
1100569-get_carter,3.6,60,7,53,11,2.9,19,1,18,5,2.5,4003,31
1100569-get_carter,3.6,60,7,53,11,2.9,19,1,18,5,2.5,4003,31
meet_the_parents,6.9,140,118,22,84,7.1,35,29,6,82,3.6,119331,79
requiem_for_a_dream,7.4,127,99,28,77,6.6,32,21,11,65,4.1,103666,93
tigerland,7,42,32,10,76,7.5,10,9,1,90,3.4,8243,68
two_family_house,7.6,33,29,4,87,8.2,10,10,0,100,3.6,294,79
1100998-contender,6.7,128,97,31,75,6.2,34,25,9,73,3.5,2093,72
dr_t_and_the_women,5.7,106,60,46,56,5.9,33,21,12,63,2.3,2922,20
just_looking,5.3,21,9,12,42,4.7,5,1,4,20,3.1,291,54
1101029-ladies_man,3.2,71,8,63,11,3.3,18,3,15,16,2.6,2790,43
1101034-lost_souls,3,89,6,83,6,2.6,26,0,26,0,2.6,2140,26
billy_jack,5.4,13,8,5,61,0,1,0,1,0,3.4,2007,63
billy_jack_goes_to_washington,2.7,7,0,7,0,0,0,0,0,0,0,0,0
1112951-time_machine,4.8,146,41,105,28,5,32,6,26,18,2.7,10389,45
thirteen_ghosts,3.4,89,11,78,12,3.4,22,3,19,13,3,20700,60
ghoulies,3,8,0,8,0,0,0,0,0,0,0,0,0
ghoulies_2,1.8,5,0,5,0,0,0,0,0,0,0,0,0
unsinkable_molly_brown,5.1,7,5,2,71,0,0,0,0,0,0,0,0
adventures_of_ichabod_and_mr_toad,7,10,9,1,90,0,3,2,1,66,3.4,2101,65
strange_love_of_martha_ivers,7.4,8,8,0,100,0,1,1,0,100,3.5,463,69
1005744-detour,8.2,17,17,0,100,0,3,3,0,100,3.7,1411,75
billy_elliot,7.2,114,97,17,85,7.3,33,29,4,87,3.4,21103,82
1101051-bedazzled,5.4,109,53,56,48,5.2,32,14,18,43,2.7,15017,45
pay_it_forward,5,125,49,76,39,4.5,35,13,22,37,3.5,22458,82
beyond,6.2,16,10,6,62,0,1,0,1,0,3.9,2574,80
private_eyes,0,3,1,2,33,0,0,0,0,0,0,0,0
legend_of_drunken_master,7,74,61,13,82,7.1,24,20,4,83,3.6,7905,83
book_of_shadows_blair_witch_2,3.4,103,13,90,12,3,29,2,27,6,2.1,7040,24
little_vampire,5.5,65,35,30,53,5,20,9,11,45,2.7,4743,54
the-bruce-movie,0,0,0,0,0,0,0,0,0,0,0,0,0
stardom,4.9,21,8,13,38,5.3,5,2,3,40,2.8,424,34
charlies_angels_full_throttle,5,171,74,97,43,5,37,15,22,40,3,33126,54
legend_of_bagger_vance,5.2,128,54,74,42,4.7,32,12,20,37,3.2,9150,64
little_nicky,3.9,113,24,89,21,3.9,31,6,25,19,3.1,32660,64
men_of_honor,5.3,102,42,60,41,5.7,31,17,14,54,3.6,13217,83
red_planet,3.7,98,12,86,12,3.4,28,3,25,10,2.6,5320,32
whats_cooking,5.5,65,34,31,52,5.2,21,10,11,47,3.4,440,64
you_can_count_on_me,8,96,91,5,94,7.7,29,27,2,93,4,2952,87
diamonds_are_forever,6.4,36,24,12,66,5.7,6,3,3,50,3.4,12688,64
1006392-eagle_has_landed,6.5,5,4,1,80,0,0,0,0,0,0,0,0
sixth_day,5.2,112,45,67,40,5.1,31,13,18,41,2.7,12583,38
bounce,5.5,105,54,51,51,5.1,32,14,18,43,2.7,3696,34
how_the_grinch_stole_christmas,5.6,127,67,60,52,5.2,31,16,15,51,3.1,34926,57
one_day_in_september,8,28,27,1,96,0,3,3,0,100,4,829,88
rugrats_in_paris,6.3,72,54,18,75,5.8,22,13,9,59,2.8,5095,48
102_dalmatians,4.4,89,27,62,30,4.2,27,8,19,29,2.9,17460,44
1101561-1101561-malena,5.6,76,42,34,55,5,30,14,16,46,3.9,7433,85
quills,6.6,118,88,30,74,6.2,35,25,10,71,3.6,9122,81
unbreakable,6.2,156,106,50,67,5.6,33,19,14,57,3.3,35079,73
boys_life_3,5.4,7,4,3,57,0,2,0,2,0,3.2,77,43
crouching_tiger_hidden_dragon,8.6,143,139,4,97,8.4,34,33,1,97,3.5,47802,81
dungeons_and_dragons,3.1,87,9,78,10,3.1,26,2,24,7,2.2,6148,30
proof_of_life,5.3,113,44,69,38,4.9,32,10,22,31,2.9,6955,44
vertical_limit,5.2,107,50,57,46,5.4,32,17,15,53,2.8,6863,44
1002947-bounty,6.2,16,13,3,81,0,3,2,1,66,3.4,2904,64
code_of_silence,5.4,10,4,6,40,0,1,1,0,100,3,1217,50
planes_trains_and_automobiles,7.8,41,39,2,95,7.1,7,6,1,85,3.4,13720,81
shes_having_a_baby,5.4,20,10,10,50,0,1,0,1,0,3.1,2609,48
living_daylights,6.1,33,24,9,72,6.1,8,5,3,62,3.1,9634,61
real-the-movie2005,0,0,0,0,0,0,0,0,0,0,0,0,0
wall_street,6.8,48,37,11,77,4.5,7,2,5,28,3.5,10858,79
born_on_the_fourth_of_july,7.3,36,32,4,88,6.6,7,5,2,71,3.3,11412,69
talk_radio,6.7,25,20,5,80,0,4,2,2,50,3.6,1535,77
1003075-brewsters_millions,4.7,20,8,12,40,0,0,0,0,0,0,0,0
snatch,6.4,136,98,38,72,5.9,34,22,12,64,4,125460,92
punchline,5.4,16,8,8,50,0,1,0,1,0,2.8,1447,35
mr_accident,3,6,1,5,16,0,0,0,0,0,0,0,0
1103080-chocolat,6,114,71,43,62,6.1,32,20,12,62,3.6,62492,82
dude_wheres_my_car,3.6,54,10,44,18,4.2,14,4,10,28,2.8,34490,52
emperors_new_groove,7,126,107,19,84,6.6,32,24,8,75,3.4,35081,75
who_the_and_is_jackson_pollock,7.4,15,15,0,100,7.8,7,7,0,100,3.5,1003,71
what_women_want,5.6,118,62,56,52,5.8,32,20,12,62,3.1,33431,60
finding_forrester,6.5,122,90,32,73,6.3,30,21,9,70,3.4,15572,76
1103231-gift,5.9,116,65,51,56,6.1,29,18,11,62,3.1,8477,56
before_night_falls,6.9,95,71,24,74,7.6,28,26,2,92,3.8,7012,79
cast_away,7.4,152,136,16,89,7.2,34,30,4,88,3.5,60473,80
family_man,5.4,125,65,60,52,4.7,31,11,20,35,3.1,19358,66
house_of_mirth,6.9,93,75,18,80,6.9,31,25,6,80,3.5,1118,69
miss_congeniality,5.1,113,46,67,40,4.3,27,8,19,29,3.2,63572,71
o_brother_where_art_thou,7.1,143,109,34,76,6.6,35,24,11,68,3.7,35122,87
songcatcher,6.3,80,57,23,71,6.3,26,19,7,73,3.7,521,77
state_and_main,7.3,113,97,16,85,6.8,29,24,5,82,3.3,2255,64
immortality2000,0,0,0,0,0,0,0,0,0,0,0,0,0
all_the_pretty_horses,4.9,99,32,67,32,4.6,33,8,25,24,3,2957,43
everlasting_piece,5.2,45,22,23,48,6.2,18,14,4,77,3.6,540,73
thirteen_days,7.1,114,94,20,82,7.1,28,24,4,85,3.4,4777,76
1103281-traffic,8,149,136,13,91,7.8,39,36,3,92,3.5,26217,81
claim,5.8,83,52,31,62,6.2,28,18,10,64,3.1,892,46
shadow_of_the_vampire,7,133,108,25,81,6.9,32,27,5,84,3.4,5965,69
house_of_games,8.2,24,23,1,95,0,1,1,0,100,3.8,1676,80
kill_me_again,0,4,4,0,100,0,0,0,0,0,0,0,0
annie_1981,4.9,23,12,11,52,0,4,2,2,50,3.1,20236,64
mother-mom-never-dies,0,0,0,0,0,0,0,0,0,0,0,0,0
officer_and_a_gentleman,7.4,16,15,1,93,0,1,1,0,100,3.5,8345,79
general-santa-ana,0,0,0,0,0,0,0,0,0,0,0,0,0
at_close_range,7.1,14,13,1,92,0,1,1,0,100,3.5,2435,71
breaker_breaker,0,1,0,1,0,0,0,0,0,0,0,0,0
breakheart_pass,6.3,7,5,2,71,0,0,0,0,0,0,0,0
friendly_persuasion,7.7,6,6,0,100,0,0,0,0,0,0,0,0
1046038-gettysburg,7.1,15,13,2,86,0,3,3,0,100,3.7,4656,86
imaginary_crimes,6.5,7,5,2,71,0,3,2,1,66,3.2,276,55
rancho_deluxe,6,12,8,4,66,0,4,1,3,25,3,463,42
the-st-francisville-experiment,0,3,0,3,0,0,0,0,0,0,0,0,0
ein-toter-hing-im-netz-horrors-of-spider-island,0,0,0,0,0,0,0,0,0,0,0,0,0
antitrust,4.1,102,25,77,24,4,31,9,22,29,2.8,5738,48
1104038-double_take,3.4,75,9,66,12,3.5,22,4,18,18,2.8,2242,47
save_the_last_dance_for_me,0,0,0,0,0,0,0,0,0,0,0,0,0
panic_room,6.9,178,136,42,76,6.6,34,24,10,70,3,19615,61
1104203-pledge,6.8,119,92,27,77,7.1,36,31,5,86,3.2,4315,55
kids_world,0,2,0,2,0,0,1,0,1,0,3.2,289,47
amati_girls,4.2,12,5,7,41,3.3,5,1,4,20,3.4,179,65
love_field,5.7,10,5,5,50,0,3,0,3,0,3.2,596,48
1093579-man_on_the_moon,6.2,117,73,44,62,5.3,31,16,15,51,3.3,15027,74
1165378-romantic_movie_favorites,0,0,0,0,0,0,0,0,0,0,0,0,0
prelude_to_a_kiss,5.8,21,13,8,61,0,4,2,2,50,2.8,2250,37
coffy,6.7,19,15,4,78,0,4,2,2,50,3.7,2668,73
foxy_brown,5.5,18,10,8,55,0,2,1,1,50,3.4,1680,67
im_gonna_git_you_sucka,5.7,26,16,10,61,4.2,5,2,3,40,3.4,2387,69
untamed_heart,5.6,25,13,12,52,0,3,2,1,66,3.4,3409,76
wedding_video,0,2,2,0,100,0,0,0,0,0,0,0,0
1104229-amy,5,14,6,8,42,6.1,6,4,2,66,3.7,361,76
invisible_circus,4.1,60,13,47,21,3.8,19,3,16,15,3,935,44
legend_of_rita,7.4,14,12,2,85,0,4,4,0,100,3.5,304,66
two-ninas,5.9,9,6,3,66,0,4,3,1,75,3,339,40
with_a_friend_like_harry,7.5,88,84,4,95,7.9,26,26,0,100,3.6,960,74
amazing_grace_and_chuck,4.4,7,2,5,28,0,2,0,2,0,0,0,0
amazon_women_on_the_moon,5.5,11,7,4,63,0,1,0,1,0,3.2,2625,53
baby_boom,6.4,16,13,3,81,0,1,1,0,100,2.9,3027,56
back_to_the_beach,5.8,14,10,4,71,0,1,1,0,100,2.9,1446,49
barfly,6.6,17,13,4,76,0,2,1,1,50,3.8,2187,82
best_seller,5.9,10,6,4,60,0,1,0,1,0,3.1,763,45
beverly_hills_cop_2,4.8,24,11,13,45,0,1,0,1,0,3.1,15724,63
beverly_hills_cop,7.1,36,30,6,83,6.4,5,3,2,60,3.4,24776,73
big_easy,7.5,13,13,0,100,0,1,1,0,100,3.3,1369,61
big_shots_funeral,4.7,15,3,12,20,0,1,0,1,0,3.6,201,72
1002361-big_town,5.5,6,4,2,66,0,1,1,0,100,3,433,30
born_in_east_la,4.9,7,3,4,42,0,0,0,0,0,0,0,0
brave_little_toaster,7.1,12,9,3,75,0,0,0,0,0,0,0,0
cant_buy_me_love,4.8,19,8,11,42,0,3,0,3,0,3.3,7122,73
cherry_2000,2.7,6,0,6,0,0,0,0,0,0,0,0,0
paul_blart_mall_cop,4.6,106,37,69,34,4.5,25,8,17,32,3.2,234394,50
1004964-critical_condition,0,1,1,0,100,0,0,0,0,0,0,0,0
cry_freedom,6.4,21,16,5,76,6,5,3,2,60,3.8,2642,86
you-must-kill,0,0,0,0,0,0,0,0,0,0,0,0,0
dawn_of_the_dead,6.7,171,130,41,76,6.1,32,20,12,62,3.4,49706,75
1005492-death_before_dishonor,0,4,0,4,0,0,1,0,1,0,2.9,538,33
disorderlies,0,2,0,2,0,0,0,0,0,0,0,0,0
dogs_in_space,0,2,1,1,50,0,0,0,0,0,0,0,0
eddie_murphy_raw,6.4,20,16,4,80,0,2,2,0,100,3.7,5495,84
empire_of_the_sun,6.8,35,28,7,80,5.7,6,3,3,50,3.9,15781,88
ernest_goes_to_camp,5.4,13,8,5,61,0,0,0,0,0,0,0,0
the-evil-dead,8.1,45,45,0,100,0,3,3,0,100,3.6,26792,81
family-viewing,0,0,0,0,0,0,0,0,0,0,0,0,0
five_corners,6.1,7,5,2,71,0,0,0,0,0,0,0,0
flowers_in_the_attic,3.4,7,1,6,14,0,0,0,0,0,0,0,0
gardens_of_stone,4.7,13,5,8,38,4.2,6,1,5,16,3.4,619,57
julia_and_julia,0,4,2,2,50,0,1,1,0,100,2.7,36,33
1008391-glass_menagerie,6,9,6,3,66,0,0,0,0,0,0,0,0
good_morning_babylon,0,4,3,1,75,0,0,0,0,0,0,0,0
hiding_out,4.7,6,2,4,33,0,1,0,1,0,3.3,562,64
hollywood-shuffle,6.5,23,20,3,86,6.6,5,4,1,80,0,0,0
hope_and_glory,8.4,17,16,1,94,0,1,1,0,100,3.7,1181,82
1009972-hot_pursuit,0,3,0,3,0,0,0,0,0,0,0,0,0
housekeeping,7.6,8,8,0,100,0,1,1,0,100,4.2,254,85
hunk,0,2,0,2,0,0,0,0,0,0,0,0,0
innerspace,6.6,34,27,7,79,6.4,6,5,1,83,3.1,4478,59
ironweed,7.4,10,9,1,90,0,1,1,0,100,3.4,1004,58
ishtar,3.4,26,5,21,19,0,1,0,1,0,2.3,1043,33
jaws-the-revenge,2,20,0,20,0,2.2,5,0,5,0,2.5,12154,30
leonard-part-6,0,0,0,0,0,0,0,0,0,0,0,0,0
less_than_zero,5.2,24,13,11,54,0,3,1,2,33,3.4,3388,65
1012362-like_father_like_son,0,1,0,1,0,0,0,0,0,0,0,0,0
lost_boys,6.3,40,30,10,75,0,4,2,2,50,3.7,48695,85
1013004-made_in_heaven,4.4,10,4,6,40,0,1,0,1,0,0,0,0
maid_to_order,4.6,11,4,7,36,0,1,0,1,0,2.8,763,50
making_mr_right,4.8,13,6,7,46,0,3,2,1,66,2.8,480,33
masters_of_the_universe,3.1,16,2,14,12,0,3,0,3,0,2.6,7837,39
monster_squad,5.5,16,9,7,56,0,2,0,2,0,3.6,8621,76
month_in_the_country,0,2,2,0,100,0,0,0,0,0,0,0,0
morgan_stewarts_coming_home,0,4,0,4,0,0,0,0,0,0,0,0,0
my_demon_lover,0,3,0,3,0,0,0,0,0,0,0,0,0
no_mans_land,7.8,97,90,7,92,8.2,24,23,1,95,4.1,3608,92
north_shore,0,2,0,2,0,0,0,0,0,0,0,0,0
1104725-head_over_heels,3.3,86,8,78,9,3.7,28,5,23,17,2.9,5738,60
left_behind,3.1,41,5,36,12,3.2,15,2,13,13,3.2,3491,66
valentine,3.1,69,6,63,8,3.1,21,3,18,14,2.5,6295,40
1104325-in_the_mood_for_love,7.6,98,86,12,87,7.6,27,23,4,85,4.4,17073,94
1125409-cabin_fever,5.9,134,84,50,62,5.2,31,15,16,48,2.6,15690,45
million_dollar_hotel,4.2,41,10,31,24,3.5,13,2,11,15,3.4,3687,64
nico_and_dani,6.6,52,45,7,86,6.8,19,15,4,78,3.5,545,69
1104385-hannibal,5.1,162,63,99,38,4.8,37,14,23,37,3.4,44476,69
saving_silverman,3.3,98,16,82,16,2.6,33,2,31,6,3,11086,52
signs_and_wonders,6,27,18,9,66,6.6,12,9,3,75,3,91,35
taste_of_others,7.9,57,57,0,100,7.8,23,23,0,100,3.8,1673,80
vatel,4.6,32,10,22,31,4.4,11,3,8,27,3.4,1090,59
1104813-down_to_earth,3.9,94,18,76,19,4,30,8,22,26,2.8,6402,46
recess_schools_out,5.9,68,42,26,61,5.3,19,10,9,52,3.1,1678,51
1104841-sweet_november,3.5,95,15,80,15,3.3,33,6,27,18,3.4,24564,76
company_man,3.3,62,9,53,14,2.9,23,1,22,4,2.9,433,40
price_of_milk,5.4,47,23,24,48,5.5,16,8,8,50,3.7,727,69
monkeybone,3.9,111,22,89,19,3.8,29,5,24,17,2.3,5059,30
3000_miles_to_graceland,3.5,95,13,82,13,2.7,23,1,22,4,2.9,8755,45
widow_of_st_pierre,7.2,76,67,9,88,7.2,29,25,4,86,3.6,806,72
mexican,5.5,127,70,57,55,4.7,33,13,20,39,2.9,16576,47
see_spot_run,3.7,76,18,58,23,4.2,25,8,17,32,2.8,4645,51
carman_the_champion,4.1,9,1,8,11,0,2,1,1,50,3.4,245,63
cavemans_valentine,5.1,80,35,45,43,4.7,29,11,18,37,3.1,1346,52
me_you_them,6.4,55,41,14,74,6.5,19,14,5,73,3.4,377,62
series_7_the_contenders,6.5,79,55,24,69,6.5,26,19,7,73,3.4,1190,65
get_over_it,5.1,62,28,34,45,5.4,18,9,9,50,2.9,9761,51
1101191-blow_dry,4,63,12,51,19,4.2,24,5,19,20,3.1,2504,53
hit_and_runway,4.5,34,11,23,32,4.1,12,3,9,25,2.6,61,19
long_nights_journey_into_day,7.5,15,14,1,93,7.7,8,8,0,100,4,115,82
when_brendan_met_trudy,5.7,60,37,23,61,5.5,24,14,10,58,3.3,72,58
mists_of_avalon,5.6,7,3,4,42,0,1,1,0,100,3.7,4639,74
madadayo,7.2,15,13,2,86,0,4,4,0,100,3.9,918,80
mirror_crackd,5.7,8,6,2,75,0,0,0,0,0,0,0,0
1040322-of_mice_and_men,7.9,25,24,1,96,8.9,6,6,0,100,3.5,6505,77
pixote,8.6,9,9,0,100,0,0,0,0,0,0,0,0
reform_school_girls,4,6,1,5,16,0,0,0,0,0,0,0,0
tapeheads,5.6,15,9,6,60,0,4,1,3,25,3,937,43
tuff_turf,4,5,1,4,20,0,1,0,1,0,3.5,827,65
unbelievable_truth,7.7,10,10,0,100,0,1,1,0,100,3.9,679,87
bishops_wife,6.5,19,15,4,78,0,4,2,2,50,3.8,1928,81
elvis_thats_the_way_it_is,6.6,7,6,1,85,0,0,0,0,0,0,0,0
fortune_cookie,7.4,21,19,2,90,0,3,3,0,100,3.6,1049,77
1012370-lilies_of_the_field,7.8,12,12,0,100,0,0,0,0,0,0,0,0
hans_christian_andersen,6,5,4,1,80,0,0,0,0,0,0,0,0
greatest_story_ever_told,4.7,18,7,11,38,0,3,2,1,66,3.5,3122,68
elmer_gantry,7.8,26,25,1,96,0,3,2,1,66,3.8,750,82
alfie,5.5,149,73,76,48,5.2,38,16,22,42,2.9,15367,49
demetrius_and_the_gladiators,0,3,2,1,66,0,0,0,0,0,0,0,0
the-fantasticks,5.2,24,12,12,50,0,2,0,2,0,3.2,418,48
i_know_where_im_going,8.8,8,8,0,100,0,0,0,0,0,0,0,0
abominable_dr_phibes,6.8,22,17,5,77,0,0,0,0,0,0,0,0
die_monster_die,5.6,5,4,1,80,0,0,0,0,0,0,0,0
dan_in_real_life,6.2,167,107,60,64,6.6,35,22,13,62,3.5,112489,70
battle_beyond_the_stars,4.1,8,2,6,25,0,0,0,0,0,0,0,0
death_warrant,0,4,0,4,0,0,0,0,0,0,0,0,0
double_impact,3.5,12,1,11,8,0,2,0,2,0,2.7,5123,45
pirates_of_the_caribbean_3,5.4,213,95,118,44,5.2,40,14,26,35,3.8,1768593,74
hot_fuzz,7.7,194,176,18,90,7.2,39,36,3,92,4,177532,88
harley_davidson_and_the_marlboro_man,3.6,15,4,11,26,0,1,0,1,0,3.2,2463,63
1012754-losin_it,3.9,8,1,7,12,0,2,1,1,50,2.7,1511,30
mermaids,6.2,15,12,3,80,0,2,1,1,50,3,6806,63
mighty_quinn,6.4,17,14,3,82,0,3,3,0,100,3.2,1203,49
1029427-navy_seals,3.8,20,4,16,20,4.1,5,2,3,40,2.9,2470,46
unmade-beds1980,0,0,0,0,0,0,0,0,0,0,0,0,0
1013248-manhunter,7.7,32,30,2,93,0,4,4,0,100,3.5,13592,70
reversal_of_fortune,7.7,32,30,2,93,8.4,7,7,0,100,3.5,1155,69
death_on_the_nile,6,11,8,3,72,0,0,0,0,0,0,0,0
deepstar-six,2.5,6,0,6,0,0,0,0,0,0,0,0,0
revenge_of_the_nerds_ii_nerds_in_paradise,3.6,18,1,17,5,0,3,0,3,0,2.6,3253,40
longtime_companion,7.7,15,15,0,100,0,1,1,0,100,3.9,741,81
4_little_girls,8.4,25,25,0,100,9.1,7,7,0,100,3.8,1088,81
girls_just_want_to_have_fun,4.5,12,4,8,33,0,0,0,0,0,0,0,0
longest_yard,4.8,163,51,112,31,5.2,35,14,21,40,3.3,198675,67
necessary_roughness,4.6,12,3,9,25,0,2,1,1,50,3,1806,45
chud,3.7,11,2,9,18,0,0,0,0,0,0,0,0
enemy_at_the_gates,5.6,135,72,63,53,5.6,31,16,15,51,3.6,31546,81
exit_wounds,4.4,64,21,43,32,4.1,18,5,13,27,2.8,6171,55
dish,7.4,95,91,4,95,7.3,26,25,1,96,3.6,1829,77
memento,8.1,135,125,10,92,7.7,32,30,2,93,4,103567,93
laughing-matters-next-gen,0,0,0,0,0,0,0,0,0,0,0,0,0
1105990-heartbreakers,5.3,115,60,55,52,4.7,32,12,20,37,2.9,11640,51
say_it_isnt_so,3.1,101,9,92,8,2.5,28,2,26,7,2.6,2001,34
too_much_sleep,6.1,45,30,15,66,6.9,21,19,2,90,1.5,3,0
1106020-someone_like_you,4.8,105,43,62,40,4.3,28,9,19,32,3.1,6824,60
spy_kids_2_island_of_lost_dreams,6.6,127,95,32,74,6.7,30,23,7,76,2.6,12329,43
tailor_of_panama,6.8,111,86,25,77,7.3,33,30,3,90,3,2860,42
amores_perros,7.8,111,102,9,91,7.7,30,29,1,96,4.2,37736,93
keep_the_river_on_your_right_a_modern_cannibal_tale,6.6,49,38,11,77,6.9,18,16,2,88,3.3,344,49
the-gleaners-and-i,7.7,37,34,3,91,7.9,13,13,0,100,4,608,87
blow,5.8,134,73,61,54,5.3,32,13,19,40,3.8,70428,88
just_visiting,4.7,76,25,51,32,4.6,23,8,15,34,2.9,2005,48
pokemon_the_movie_3,4,53,12,41,22,3.9,16,3,13,18,3.1,4327,57
beautiful_creatures,4.8,59,22,37,37,4.7,19,7,12,36,3,741,38
brigham_city,6.2,24,17,7,70,6.7,7,6,1,85,3.4,535,70
day_i_became_a_woman,7.3,56,49,7,87,7.6,23,22,1,95,4,301,82
shadow_magic,6.2,49,35,14,71,6.9,19,15,4,78,3.5,284,58
bridget_jones_diary,6.8,151,121,30,80,6.2,35,24,11,68,3.3,70748,77
joe_dirt,3,74,8,66,10,2.7,24,1,23,4,2.8,16165,63
josie_and_the_pussycats,5.2,118,62,56,52,5.6,29,17,12,58,2.6,7768,45
kingdom_come,4.3,64,18,46,28,4.3,22,7,15,31,3.4,1386,66
10009225-body_of_lies,5.8,194,102,92,52,5.6,40,21,19,52,3.5,38376,66
chopper,6.4,64,45,19,70,7,20,17,3,85,3.9,6049,89
1105687-circle,7.8,60,56,4,93,7.9,20,19,1,95,3.7,578,75
lakeboat,6.6,41,34,7,82,6.5,15,11,4,73,3.2,199,57
crocodile_dundee_in_los_angeles,3.6,77,9,68,11,3.6,23,2,21,8,2.4,8135,37
freddy_got_fingered,2.7,91,10,81,10,2.6,27,2,25,7,2.5,14822,54
center_of_the_world,4.8,80,27,53,33,3.6,24,3,21,12,3,592,42
sweet_and_lowdown,6.8,59,46,13,77,6.5,16,11,5,68,3.6,3877,76
luzhin_defence,5.9,71,42,29,59,6.1,23,14,9,60,3.5,403,68
jonas_brothers_3d,4.2,71,16,55,22,4.6,22,7,15,31,3.3,74109,64
1090236-lilies,7.2,7,7,0,100,0,2,2,0,100,4,517,83
1018324-scarface,7.5,50,44,6,88,8,5,4,1,80,4.1,121090,93
1005381-days_of_wine_and_roses,9,7,7,0,100,0,0,0,0,0,0,0,0
1107198-driven,3.6,108,14,94,12,3.6,27,3,24,11,2.5,7367,40
forsaken,3.3,53,4,49,7,3.5,11,2,9,18,2.9,2483,45
one_night_at_mccools,4.7,102,34,68,33,4,31,7,24,22,2.7,2770,38
town_and_country,3.5,89,12,77,13,3.7,24,4,20,16,2.4,717,16
ratatouille,8.4,213,205,8,96,8.3,42,41,1,97,3.9,414956,84
mummy_returns,5.2,137,64,73,46,5.2,33,15,18,45,3.3,65125,69
1107897-eureka,7.2,42,38,4,90,6.8,19,16,3,84,4.1,667,88
tuvalu,6.8,26,19,7,73,6.3,6,3,3,50,4.1,583,90
under_the_sand,7.5,70,66,4,94,7.8,23,23,0,100,3.7,924,79
1004330-cleopatra,5.4,20,8,12,40,0,3,2,1,66,3.4,3444,73
monster-in-the-forest-the-story-of-the-cyclop,0,0,0,0,0,0,0,0,0,0,0,0,0
lost_in_america,7.9,24,23,1,95,0,1,1,0,100,3.5,869,71
lost_world_jurassic_park,5.6,59,29,30,49,5.1,13,6,7,46,3.2,46513,55
triumph_of_the_will,7.8,16,15,1,93,0,0,0,0,0,0,0,0
true_believer,7,22,21,1,95,0,4,3,1,75,3.2,549,49
world_according_to_garp,6.3,14,11,3,78,0,1,1,0,100,3.5,3647,75
candy,5.8,74,36,38,48,6.1,24,14,10,58,3.8,9542,78
fellini_satyricon,7,22,17,5,77,7.3,5,4,1,80,3.7,3120,73
fellinis_roma,6.5,12,7,5,58,0,2,1,1,50,3.9,1894,82
1037161-frankie_and_johnny,6.8,17,13,4,76,0,2,1,1,50,3.2,4527,62
1037161-frankie_and_johnny,6.8,17,13,4,76,0,2,1,1,50,3.2,4527,62
1046076-home_of_our_own,5.7,11,5,6,45,0,3,1,2,33,3.3,706,67
paris_when_it_sizzles,5.8,7,4,3,57,0,0,0,0,0,0,0,0
pola_x,6.6,20,15,5,75,6.9,7,6,1,85,3.3,449,54
city_of_women,7.1,9,7,2,77,0,2,1,1,50,3.7,1181,74
boy-a,7.5,57,51,6,89,7.5,23,20,3,86,3.5,5895,84
9_to_5,6.9,25,22,3,88,0,1,1,0,100,3.2,3894,70
norma_rae,7.5,19,17,2,89,0,3,2,1,66,3.5,1339,77
summer_rental,4.4,13,2,11,15,0,0,0,0,0,0,0,0
the-5000-fingers-of-dr-t,6.8,13,10,3,76,0,0,0,0,0,0,0,0
backtrack,5.2,7,3,4,42,0,0,0,0,0,0,0,0
love_story,5.8,21,12,9,57,0,4,4,0,100,3.5,10498,75
pelle_the_conqueror,7.3,8,8,0,100,0,1,1,0,100,3.9,852,86
du-rififi-chez-les-hommes-rififi,8.1,40,37,3,92,7.8,9,8,1,88,4.3,2008,95
knights_tale,5.8,137,79,58,57,5.7,34,20,14,58,3.5,77647,80
bread_and_roses,6.1,62,40,22,64,6.3,21,15,6,71,3.7,1038,76
calle_54,7.2,47,41,6,87,7.7,19,17,2,89,3.7,351,74
king_is_alive,5.8,65,39,26,60,4.7,16,6,10,37,3.3,375,55
sordid_lives,4.4,27,10,17,37,4.1,8,2,6,25,4.1,754,87
startupcom,7.6,92,85,7,92,7.4,30,27,3,90,3.4,490,65
angel-links,0,0,0,0,0,0,0,0,0,0,0,0,0
shrek,7.7,174,155,19,89,7.6,36,31,5,86,3.9,208170,87
fast_food_fast_women,4.8,35,17,18,48,4.5,14,6,8,42,3.4,504,63
1107863-moulin_rouge,7,168,130,38,77,6.1,35,23,12,65,3.7,110817,88
petits_freres,5.7,13,8,5,61,0,4,4,0,100,2.6,22,25
1108389-pearl_harbor,4.3,159,41,118,25,4.1,36,8,28,22,3.3,80658,73
bloody-angels,6.7,8,6,2,75,0,2,2,0,100,5,5,100
himalaya,7.2,53,47,6,88,7.5,19,17,2,89,4,571,89
man_who_cried,4.7,68,24,44,35,4.3,23,6,17,26,3.4,8886,61
1114093-gabriela,0,2,0,2,0,0,0,0,0,0,0,0,0
ice_castles,5.2,7,3,4,42,0,1,0,1,0,3.5,1225,71
love_potion_9,3.7,11,3,8,27,0,0,0,0,0,0,0,0
postcards_from_the_edge,6.8,20,18,2,90,0,2,2,0,100,3.3,2163,63
apache,5.5,6,4,2,66,0,0,0,0,0,0,0,0
buffalo_bill_and_the_indians_or_sitting_bulls_history_lesson,6.3,11,8,3,72,0,2,1,1,50,3.2,745,53
city_slickers,6.7,26,23,3,88,0,2,2,0,100,3.1,7371,59
eight_men_out,7.2,36,31,5,86,4.8,6,2,4,33,3.6,2938,76
horse_soldiers,7.4,5,5,0,100,0,0,0,0,0,0,0,0
kentuckian,0,1,0,1,0,0,0,0,0,0,0,0,0
notte,6.8,14,10,4,71,0,1,1,0,100,4.2,1605,92
mississippi_burning,6.3,14,12,2,85,0,1,1,0,100,3.7,6011,87
1013077-magnificent_seven,7.9,27,25,2,92,0,0,0,0,0,0,0,0
return_of_the_magnificent_seven,3.3,7,1,6,14,0,0,0,0,0,0,0,0
rio_bravo,8.2,33,33,0,100,7.2,5,5,0,100,4,4947,89
scarlet_empress,9,11,11,0,100,0,0,0,0,0,0,0,0
semitough,6.6,5,4,1,80,0,2,1,1,50,3,355,32
usual_suspects,7.5,47,41,6,87,6.9,14,12,2,85,4.2,109588,95
throw_momma_from_the_train,5.6,25,15,10,60,0,1,0,1,0,2.9,4120,51
the-last-days-of-hsin-yang,0,0,0,0,0,0,0,0,0,0,0,0,0
midnight_madness,0,3,0,3,0,0,1,0,1,0,3.6,703,71
1104068-nightwatch,0,4,2,2,50,0,0,0,0,0,0,0,0
sand_pebbles,7,16,14,2,87,0,0,0,0,0,0,0,0
1022172-twelve_oclock_high,8.2,14,14,0,100,0,0,0,0,0,0,0,0
von_ryans_express,6.8,11,10,1,90,0,0,0,0,0,0,0,0
national_lampoons_animal_house,7.7,40,36,4,90,7.1,5,4,1,80,3.7,25149,88
whats_the_worst_that_could_happen,3.5,96,10,86,10,3.3,31,1,30,3,2.7,2321,41
big_eden,6,51,33,18,64,5.4,19,9,10,47,3.9,895,80
underworld_evolution,3.7,100,15,85,15,3.5,16,1,15,6,3.6,111035,77
swordfish,4.3,134,34,100,25,3.5,34,6,28,17,3.2,30360,64
anniversary_party,5.8,111,67,44,60,5.5,31,18,13,58,3.2,1519,54
the-wind2001,0,0,0,0,0,0,0,0,0,0,0,0,0
divided_we_fall,7.3,61,55,6,90,7.7,23,22,1,95,4,599,89
whatever_happened_to_harold_smith,4.6,10,4,6,40,0,3,0,3,0,3.5,629,61
catch22,7.2,23,20,3,86,0,1,1,0,100,3.6,3246,74
forgotten_silver,7.5,10,10,0,100,0,2,2,0,100,3.7,1179,77
point_break,6,49,33,16,67,4.4,7,2,5,28,3.3,19358,75
shag_the_movie,6,14,9,5,64,0,4,3,1,75,3.9,1799,84
1022314-uncommon_valor,6.1,9,5,4,55,0,1,0,1,0,3.4,1161,64
unlawful_entry,6.2,30,22,8,73,6.4,7,6,1,85,3.1,1826,44
youngblood,3.8,6,2,4,33,0,1,0,1,0,3.4,2381,67
gentlemen_prefer_blondes,7.8,34,34,0,100,0,4,4,0,100,3.7,7651,82
how_to_marry_a_millionaire,7,13,12,1,92,0,0,0,0,0,0,0,0
seven_year_itch,7.3,25,22,3,88,0,4,3,1,75,3.6,5407,75
theres_no_business_like_show_business,6.4,11,8,3,72,0,0,0,0,0,0,0,0
tootsie,7.6,39,34,5,87,8.2,6,6,0,100,3.4,12431,75
1070693-boys_next_door,0,0,0,0,0,0,0,0,0,0,0,0,0
too_late_the_hero,6,11,8,3,72,0,3,1,2,33,3.4,437,64
pavilion_of_women,3.1,31,2,29,6,2.6,12,0,12,0,3.4,326,65
atlantis_the_lost_empire,5.3,125,57,68,45,5,30,12,18,40,2.9,15720,50
lara_croft_tomb_raider,3.9,154,29,125,18,3.9,35,7,28,20,3.1,46926,60
dr_dolittle_2,4.9,104,42,62,40,5.4,31,14,17,45,2.8,16612,43
1108372-fast_and_the_furious,5.4,143,76,67,53,5.7,33,21,12,63,3.4,122441,81
ai_artificial_intelligence,6.6,186,135,51,72,6.4,40,27,13,67,3.1,42316,58
baby_boy,6.1,90,62,28,68,6.3,31,24,7,77,3.8,15836,85
crazy-beautiful,5.8,97,61,36,62,5.6,29,17,12,58,3.1,9723,68
pootie_tang,3.8,41,11,30,26,4.2,18,7,11,38,2.7,4226,56
let_it_snow,5,17,9,8,52,5.5,7,4,3,57,3.2,238,55
adventures_of_felix,6.3,39,27,12,69,6.4,15,11,4,73,3.4,60,52
down_from_the_mountain,7.5,31,30,1,96,7.9,11,11,0,100,3.5,336,75
russian_dolls,6.6,47,34,13,72,6.8,17,11,6,64,3.6,8145,76
sexy_beast,7.2,118,101,17,85,7.7,31,30,1,96,3.7,7958,83
south_of_heaven_west_of_hell,3.5,7,1,6,14,0,0,0,0,0,0,0,0
closet,7,79,68,11,86,6.7,24,18,6,75,3.7,2303,76
dances_with_wolves,7,46,35,11,76,6.9,10,7,3,70,3.6,28000,84
crimson_rivers,6,53,36,17,67,4.9,16,6,10,37,3.5,3727,70
lumumba,7,55,46,9,83,7.2,23,20,3,86,3.9,339,81
pandaemonium,5.7,26,15,11,57,4.9,7,3,4,42,3.7,260,70
truth_about_cats_and_dogs,6.7,36,30,6,83,7.6,6,5,1,83,2.9,6120,55
kiss_of_the_dragon,5.3,103,53,50,51,5.2,27,13,14,48,3.3,12628,70
scary_movie_2,3.3,106,15,91,14,3.2,29,2,27,6,3,85716,68
lost_and_delirious,5.4,58,29,29,50,5.6,22,11,11,50,3.8,3998,79
baisemoi,4.2,56,12,44,21,3.7,19,1,18,5,2.7,2080,38
vertical_ray_of_the_sun,7.1,55,45,10,81,7,20,17,3,85,4,746,84
another_woman,6.2,20,12,8,60,5.7,6,3,3,50,3.7,1472,75
beach_blanket_bingo,5.4,7,5,2,71,0,0,0,0,0,0,0,0
big_deal_on_madonna_street,7.3,8,7,1,87,0,0,0,0,0,0,0,0
cannonball_run,4.2,29,9,20,31,0,3,0,3,0,3.1,6545,59
cannonball_run_2,2.4,9,1,8,11,0,1,0,1,0,2.7,2869,42
speed_zone,0,4,0,4,0,0,1,0,1,0,3,765,43
1005815-diary_of_a_chambermaid,8,19,16,3,84,0,1,0,1,0,3.8,1018,82
the-reef,0,0,0,0,0,0,0,0,0,0,0,0,0
dr_goldfoot_and_the_bikini_machine,3.8,5,1,4,20,0,0,0,0,0,0,0,0
1007021-fall_of_the_house_of_usher,6.7,21,18,3,85,0,2,1,1,50,3.5,2068,69
faust_love_of_the_damned,0,3,1,2,33,0,0,0,0,0,0,0,0
last_laugh,9,24,24,0,100,0,3,3,0,100,4.1,1020,90
man_who_shot_liberty_valance,8.6,34,33,1,97,0,2,2,0,100,4,5590,89
10006953-salvador,0,2,0,2,0,0,1,0,1,0,0,0,0
september_11,6.6,58,45,13,77,6.6,21,16,5,76,3.5,303,62
shadows_and_fog,5.9,21,12,9,57,0,0,0,0,0,0,0,0
something_wild,7,28,24,4,85,6.2,5,3,2,60,3.2,1139,58
sons_of_katie_elder,6.6,11,11,0,100,0,0,0,0,0,0,0,0
thing_with_two_heads,2.1,7,0,7,0,0,1,0,1,0,2.8,123,36
village_of_the_giants,0,4,0,4,0,0,0,0,0,0,0,0,0
cheech_and_chongs_nice_dreams,4.5,7,3,4,42,0,0,0,0,0,0,0,0
day_the_earth_caught_fire,6.5,6,5,1,83,0,0,0,0,0,0,0,0
the-house-by-the-cemetery,4.6,6,2,4,33,0,0,0,0,0,0,0,0
cheech_and_chong_things_are_tough_all_over,0,1,1,0,100,0,0,0,0,0,0,0,0
all_that_heaven_allows,7.6,26,24,2,92,0,3,1,2,33,0,0,0
barefoot_contessa,7.5,8,8,0,100,0,1,1,0,100,3.6,1121,70
1177641-blackout,0,3,1,2,33,0,0,0,0,0,0,0,0
cries_and_whispers,8.2,27,24,3,88,8,5,4,1,80,4.3,3227,91
1032798-entertainer,7.8,8,7,1,87,0,0,0,0,0,0,0,0
the-garden-of-the-finzicontinis,8.1,12,12,0,100,0,3,3,0,100,3.9,483,81
howling_iii,3,10,2,8,20,0,0,0,0,0,0,0,0
kiss_me_deadly,7.9,26,25,1,96,0,4,3,1,75,4,1672,85
1012386-lion_in_winter,8,21,20,1,95,0,4,4,0,100,4.1,3596,88
misfits,7.8,13,13,0,100,0,0,0,0,0,0,0,0
1080898-moby_dick,6.2,6,4,2,66,0,0,0,0,0,0,0,0
1017391-rembrandt,0,4,3,1,75,0,0,0,0,0,0,0,0
sweet_smell_of_success,8.7,41,41,0,100,8.2,7,7,0,100,4.1,1652,91
written_on_the_wind,7.4,21,17,4,80,0,1,1,0,100,3.8,927,76
tenth_victim,0,4,4,0,100,0,0,0,0,0,0,0,0
colonel_redl,0,3,3,0,100,0,0,0,0,0,0,0,0
1015361-obsession,6,14,11,3,78,0,1,1,0,100,3.3,664,58
1020662-suspiria,7.9,30,28,2,93,0,3,3,0,100,3.9,7987,84
laugh-track-the-chinese-connection,0,0,0,0,0,0,0,0,0,0,0,0,0
christiane_f,0,4,3,1,75,0,1,1,0,100,3.9,1584,83
fists_of_fury,5.6,10,6,4,60,0,0,0,0,0,0,0,0
1008085-game_of_death,6,8,6,2,75,0,0,0,0,0,0,0,0
the-last-dragon,0,4,0,4,0,0,1,0,1,0,3.9,4398,84
outland,5.8,22,13,9,59,0,3,2,1,66,0,0,0
return_of_the_dragon,6.5,8,8,0,100,0,0,0,0,0,0,0,0
imax_trex_back_to_the_cretaceous,6.1,19,13,6,68,6.5,7,5,2,71,2.8,304,34
final_fantasy_the_spirits_within,5.2,141,61,80,43,4.8,28,9,19,32,3,17822,54
1155861-blonde,0,1,0,1,0,0,0,0,0,0,0,0,0
1108799-score,6.5,126,93,33,73,6.1,34,21,13,61,3.3,12417,64
adanggaman,6.7,10,9,1,90,0,3,3,0,100,3.5,119,55
bully,5.6,83,42,41,50,4.9,22,9,13,40,3.5,6131,70
jump_tomorrow,6.6,54,44,10,81,6.9,19,17,2,89,4.1,302,88
made,6.3,107,75,32,70,5.9,31,20,11,64,3.3,3264,66
michael-jordan-to-the-max,6.2,25,16,9,64,4.7,8,1,7,12,3.8,753,78
more1998,0,0,0,0,0,0,0,0,0,0,0,0,0
bianca-beauchamp-all-access-2-rubberized,0,0,0,0,0,0,0,0,0,0,0,0,0
imax_africa_the_serengeti,8,5,5,0,100,0,0,0,0,0,0,0,0
imax_alaska_spirit_of_the_world,0,3,3,0,100,0,0,0,0,0,0,0,0
1136658-siegfried_and_roy_the_magic_box,6.5,14,10,4,71,0,4,3,1,75,3.2,48,40
18_again,4,7,2,5,28,0,1,0,1,0,2.8,1550,44
accidental_tourist,7.1,26,21,5,80,0,2,1,1,50,3.2,1424,57
1000224-accused,7.1,19,18,1,94,0,1,1,0,100,3.5,3437,77
above_the_law,5.1,14,8,6,57,0,2,1,1,50,2.8,5280,52
adventures_of_baron_munchausen,7.2,27,24,3,88,0,3,3,0,100,0,0,0
apartment_zero,6.9,18,17,1,94,0,4,3,1,75,3.5,629,64
appointment_with_death,0,2,0,2,0,0,0,0,0,0,0,0,0
little_mermaid_ariels_beginning,0,4,2,2,50,0,0,0,0,0,0,0,0
arthur_2_on_the_rocks,3.3,13,2,11,15,0,1,0,1,0,2.5,865,33
bad_dreams,3.3,8,1,7,12,0,1,0,1,0,3.1,374,46
bat_21,6.1,10,8,2,80,0,2,1,1,50,3.1,1497,51
beach,4.4,116,22,94,18,3.9,31,4,27,12,2.9,21479,59
1001878-beast,0,1,1,0,100,0,0,0,0,0,0,0,0
big_business-1929,0,2,2,0,100,0,0,0,0,0,0,0,0
big_top_peewee,4.6,19,6,13,31,0,1,0,1,0,2.5,2934,32
biloxi_blues,6,18,13,5,72,0,1,0,1,0,3.1,2051,52
1002448-birds,8,40,38,2,95,0,4,2,2,50,3.5,17449,80
1002585-blob,5.6,16,9,7,56,0,0,0,0,0,0,0,0
boost,5.1,6,3,3,50,0,1,1,0,100,3.2,281,52
1003098-bright_lights_big_city,5.5,18,11,7,61,5.6,5,3,2,60,2.8,1095,37
caddyshack_2,1.9,11,0,11,0,0,1,0,1,0,2.4,2756,26
camille_claudel,8.3,8,8,0,100,0,1,1,0,100,3.9,1318,85
casual_sex,0,3,0,3,0,0,0,0,0,0,0,0,0
clean_and_sober,5.3,11,6,5,54,0,1,1,0,100,3.2,1014,60
1004420-cocktail,3.7,21,3,18,14,0,2,0,2,0,3,13625,60
1004485-colors,6.7,28,23,5,82,7.3,6,5,1,83,3.3,5019,66
coming_to_america,5.7,36,23,13,63,2.5,5,0,5,0,3.4,32197,82
couch_trip,5.2,7,3,4,42,0,1,0,1,0,2.9,521,40
criminal_law,4.6,8,3,5,37,0,1,0,1,0,3,410,35
critters,5.2,14,8,6,57,0,1,1,0,100,2.7,6045,43
critters_2_the_main_course,4.4,9,3,6,33,0,1,0,1,0,2.6,2866,38
critters_3,2.8,6,0,6,0,0,0,0,0,0,0,0,0
crossing_delancey,6.9,20,17,3,85,0,1,0,1,0,3.6,495,75
doa_dead_or_alive,4.5,44,15,29,34,4.2,10,2,8,20,2.7,71044,43
1005399-dead_heat,0,3,1,2,33,0,0,0,0,0,0,0,0
dead_pool,5.6,26,14,12,53,0,1,1,0,100,3.2,4365,49
dirty_rotten_scoundrels,6.9,31,27,4,87,0,4,4,0,100,3.4,7136,78
drowning-by-numbers,7.1,11,10,1,90,0,1,0,1,0,4.2,1008,91
elvira_mistress_of_the_dark,4.3,9,3,6,33,0,0,0,0,0,0,0,0
ernest_saves_christmas,4.7,13,5,8,38,0,0,0,0,0,0,0,0
everybodys_allamerican,4.8,10,3,7,30,0,1,0,1,0,3.1,505,45
1007195-feds,4.3,5,1,4,20,0,1,1,0,100,3,269,50
for_keeps,4.3,9,2,7,22,0,1,1,0,100,3.4,2404,64
1007832-frantic,6.4,39,30,9,76,5.6,5,3,2,60,3.2,4749,56
fresh_horses,3.6,6,0,6,0,0,0,0,0,0,0,0,0
gorillas_in_the_mist,6.8,17,14,3,82,0,2,2,0,100,3.3,3826,72
great_outdoors,4.2,13,5,8,38,0,0,0,0,0,0,0,0
10010193-heartbreak_hotel,0,1,1,0,100,0,0,0,0,0,0,0,0
high_spirits,3.4,11,2,9,18,0,0,0,0,0,0,0,0
hot_to_trot,2.3,6,0,6,0,0,0,0,0,0,0,0,0
house_on_carroll_street,5.6,6,4,2,66,0,1,1,0,100,2.9,262,21
howling_iv_the_original_nightmare,0,0,0,0,0,0,0,0,0,0,0,0,0
johnny_be_good,2.3,11,0,11,0,0,3,0,3,0,2.6,1294,27
lady_in_white,6.2,11,8,3,72,0,1,1,0,100,3.5,1031,70
lair_of_the_white_worm,5.5,21,12,9,57,0,1,0,1,0,2.9,1348,43
land_before_time,5.9,14,10,4,71,0,1,1,0,100,3.3,18763,69
license_to_drive,3.2,17,3,14,17,0,3,0,3,0,3,3880,61
little_nikita,5.7,7,6,1,85,0,1,0,1,0,3.1,1024,47
1013488-masquerade,5.1,14,6,8,42,0,1,1,0,100,3.1,407,41
milagro_beanfield_war,5.9,27,16,11,59,5.9,6,3,3,50,3.6,855,72
moon_over_parador,4.8,12,5,7,41,0,1,0,1,0,2.9,529,39
1014316-moving,0,3,1,2,33,0,0,0,0,0,0,0,0
my_stepmother_is_an_alien,3.6,15,2,13,13,0,1,0,1,0,2.5,3796,32
night_in_the_life_of_jimmy_reardon,4.8,5,2,3,40,0,0,0,0,0,0,0,0
off_limits,4.9,8,4,4,50,0,1,0,1,0,3,458,31
bagdad_cafe,6.7,16,14,2,87,0,2,1,1,50,4,2378,88
permanent_record,6.7,8,6,2,75,0,1,1,0,100,3.4,779,65
1017328-red_heat,5.3,15,8,7,53,0,1,1,0,100,2.7,4602,38
return_of_the_living_dead_2,3.3,13,0,13,0,0,1,0,1,0,2.9,4031,47
return_of_the_living_dead,7,26,23,3,88,0,1,1,0,100,3.3,10213,71
suitors,0,1,0,1,0,0,0,0,0,0,0,0,0
man_from_snowy_river,6.5,10,8,2,80,0,1,0,1,0,3.7,3791,85
rocket_gibraltar,0,2,1,1,50,0,0,0,0,0,0,0,0
running_on_empty,6.9,11,9,2,81,0,2,1,1,50,3.8,1817,84
salomes_last_dance,5.8,6,3,3,50,0,1,0,1,0,3.9,233,81
salsa-2000,0,0,0,0,0,0,0,0,0,0,0,0,0
the-rainbow-the-widowing-of-mrs-holroyd,0,0,0,0,0,0,0,0,0,0,0,0,0
1018704-shakedown,0,1,1,0,100,0,1,1,0,100,2.9,382,32
1018880-shoot_to_kill,7.1,11,11,0,100,0,1,1,0,100,3.2,950,57
1018891-short_circuit,4.8,20,10,10,50,0,1,0,1,0,3.2,12589,66
1018891-short_circuit,4.8,20,10,10,50,0,1,0,1,0,3.2,12589,66
1036630-vanishing,8.4,33,33,0,100,0,4,4,0,100,4,2421,87
stormy_monday,6.6,9,8,1,88,0,1,1,0,100,3.1,420,41
before_sunset,8.3,158,150,8,94,8.4,39,38,1,97,4,20750,90
sweet_hearts_dance,5.5,10,5,5,50,0,1,0,1,0,3.2,431,45
switching_channels,5.3,9,5,4,55,0,1,1,0,100,2.9,314,31
telephone,0,0,0,0,0,0,0,0,0,0,0,0,0
tetsuo-the-ironman,7.2,12,9,3,75,0,0,0,0,0,0,0,0
they_live,7,33,29,4,87,0,4,2,2,50,3.5,7637,77
to_kill_a_priest,0,4,3,1,75,0,1,0,1,0,3.5,191,68
torch_song_trilogy,6.1,13,7,6,53,0,2,2,0,100,4,1240,89
track_29,6.4,6,4,2,66,0,2,1,1,50,3.2,444,49
tucker_the_man_and_his_dream,7.2,35,30,5,85,6.8,7,5,2,71,3.2,1497,58
1022191-twins,4.7,27,9,18,33,0,4,3,1,75,2.7,10066,41
1022570-vice_versa,5,13,6,7,46,0,1,1,0,100,2.8,1418,40
watcher,3.4,87,9,78,10,3.3,25,2,23,8,2.7,3820,36
waxwork,4.7,9,5,4,55,0,0,0,0,0,0,0,0
without_a_clue,5.2,9,5,4,55,0,1,0,1,0,3.4,1126,68
young_einstein,3,17,3,14,17,0,1,0,1,0,2.6,1565,44
first_20_million_is_always_the_hardest,2.4,9,1,8,11,0,2,0,2,0,3.2,483,50
american_ninja,2.6,5,0,5,0,0,0,0,0,0,0,0,0
american_ninja_2_the_confrontation,0,0,0,0,0,0,0,0,0,0,0,0,0
american-ninja-3-blood-hunt,0,0,0,0,0,0,0,0,0,0,0,0,0
1002142-best_of_the_best,0,4,2,2,50,0,1,0,1,0,3.2,4991,62
best_of_the_best_2,3,9,1,8,11,0,1,0,1,0,2.9,1415,46
bill_and_teds_excellent_adventure,6.3,32,26,6,81,0,3,1,2,33,3.3,30577,70
1002512-black_rain,5.4,21,12,9,57,0,1,0,1,0,0,0,0
blaze,6.3,10,8,2,80,0,1,1,0,100,2.9,402,40
blind_fury,4.8,10,6,4,60,0,1,0,1,0,3.1,1813,52
1183674-hunting_party,6,89,47,42,52,5.8,26,12,14,46,3.4,13820,67
chud_2,0,0,0,0,0,0,0,0,0,0,0,0,0
casualties_of_war,7.2,30,25,5,83,0,2,1,1,50,3.4,4154,70
chances_are,5.6,25,15,10,60,4.6,6,2,4,33,3.4,2184,66
cyborg,2.9,14,2,12,14,0,3,0,3,0,2.5,3775,35
getting_even_with_dad,3.3,12,1,11,8,0,3,0,3,0,2.4,2200,29
dead_bang,4.4,10,3,7,30,0,0,0,0,0,0,0,0
disorganized_crime,5.3,6,3,3,50,0,0,0,0,0,0,0,0
dream_a_little_dream,3,9,0,9,0,0,3,0,3,0,3.3,2148,67
1006287-dream_team,5.2,13,7,6,53,0,1,0,1,0,3.1,1533,60
dry_white_season,6.4,11,10,1,90,0,1,1,0,100,0,0,0
earth_girls_are_easy,5.5,32,20,12,62,6.8,7,6,1,85,2.6,5342,40
eddie_and_the_cruisers_2_eddie_lives,0,0,0,0,0,0,0,0,0,0,0,0,0
eddie_and_the_cruisers,5.6,8,3,5,37,0,1,0,1,0,3.5,2405,71
1006690-erik_the_viking,4,10,3,7,30,0,1,0,1,0,3.2,1894,59
experts,0,0,0,0,0,0,0,0,0,0,0,0,0
family_business,5.1,15,6,9,40,0,1,1,0,100,2.8,1601,28
farewell_to_the_king,5.5,11,6,5,54,0,1,1,0,100,3.2,415,53
fat_man_and_little_boy,5.2,17,9,8,52,0,3,1,2,33,3.1,908,44
girl_in_a_swing,0,3,1,2,33,0,1,0,1,0,2.4,61,25
gleaming_the_cube,4.2,8,2,6,25,0,0,0,0,0,0,0,0
going_overboard,0,3,0,3,0,0,0,0,0,0,0,0,0
great_balls_of_fire,5.8,24,15,9,62,0,2,0,2,0,3,3034,52
gross_anatomy,4.6,10,3,7,30,0,1,1,0,100,2.9,620,43
1083093-happy_together,7.1,31,24,7,77,7.1,9,7,2,77,4.1,4907,90
harlem_nights,3.8,14,3,11,21,0,3,0,3,0,3.3,5383,78
her_alibi,3.8,13,2,11,15,0,1,0,1,0,2.7,795,37
homer_and_eddie,2.3,7,0,7,0,0,0,0,0,0,0,0,0
how_to_get_ahead_in_advertising,6.3,14,8,6,57,0,1,0,1,0,3.7,1015,78
immediate_family,5,10,6,4,60,0,1,0,1,0,3.4,323,59
north_country,6.7,166,114,52,68,6.8,38,26,12,68,3.5,14739,72
innocent_man,4.8,7,2,5,28,0,1,0,1,0,2.9,1267,42
jacknife,6,13,9,4,69,0,1,1,0,100,3.2,827,45
january_man,3.8,14,3,11,21,0,1,0,1,0,2.8,957,31
johnny_handsome,6.2,13,8,5,61,0,1,1,0,100,3,857,42
jesus_of_montreal,7.4,13,11,2,84,0,2,1,1,50,3.9,1256,85
k9,4.1,8,2,6,25,0,1,0,1,0,2.7,4457,46
1011487-kickboxer,0,4,2,2,50,0,0,0,0,0,0,0,0
last_exit_to_brooklyn,6.6,13,10,3,76,0,2,1,1,50,3.6,623,73
lean_on_me,5.8,14,9,5,64,0,1,0,1,0,3.7,5235,86
let_it_ride,5,10,3,7,30,0,0,0,0,0,0,0,0
leviathan,4,19,2,17,10,0,2,0,2,0,2.7,1532,31
little_monsters,0,3,1,2,33,0,0,0,0,0,0,0,0
1012605-lock_up,4.3,10,2,8,20,0,0,0,0,0,0,0,0
look_whos_talking,5,33,19,14,57,3.9,7,2,5,28,2.9,13369,53
loverboy_2004,4.1,34,6,28,17,4.6,12,3,9,25,2.7,12704,32
major_league,6.6,31,26,5,83,0,4,2,2,50,3.3,13020,78
meet_the_feebles,6.6,20,15,5,75,0,1,0,1,0,3.5,3519,71
miracle_mile,6.7,21,18,3,85,0,1,1,0,100,3.5,1088,70
miss_firecracker,6,9,6,3,66,0,1,1,0,100,3.2,403,49
new_york_stories,6.1,23,17,6,73,6.4,5,3,2,60,3.4,3295,57
1014946-next_of_kin,4.6,7,3,4,42,0,0,0,0,0,0,0,0
no_holds_barred,1.7,8,0,8,0,0,0,0,0,0,0,0,0
old_gringo,5.1,11,5,6,45,0,1,0,1,0,3.1,298,42
package,5.3,14,9,5,64,0,2,2,0,100,3.2,849,45
meet_the_parents,6.9,140,118,22,84,7.1,35,29,6,82,3.6,119331,79
penn_and_teller_get_killed,4.6,7,1,6,14,0,0,0,0,0,0,0,0
pink_cadillac,3.9,18,3,15,16,4.4,5,2,3,40,2.8,2125,30
punisher_war_zone,4.2,96,25,71,26,3.7,21,1,20,4,3,29393,47
red_scorpion,3.3,9,1,8,11,0,3,0,3,0,0,0,0
americas_sweethearts,4.6,142,45,97,31,4,37,7,30,18,2.8,17330,43
o_brother_where_art_thou,7.1,143,109,34,76,6.6,35,24,11,68,3.7,35122,87
ghost_world,7.8,148,136,12,91,8,33,32,1,96,3.6,20727,81
hedwig_and_the_angry_inch,7.8,103,95,8,92,7.7,30,27,3,90,4.1,11932,91
1016397-planet_of_the_apes,7.4,44,39,5,88,5.5,5,3,2,60,3.4,12844,80
bread_and_tulips,6.3,62,44,18,70,6.3,22,17,5,77,3.9,1393,85
1061860-cure,5.5,10,4,6,40,0,4,1,3,25,3.7,2207,79
greenfingers,5.2,67,31,36,46,4.6,25,9,16,36,3.5,1333,68
wet_hot_american_summer,4.3,63,19,44,30,3.7,20,3,17,15,3.7,7016,85
relentless,0,4,1,3,25,0,0,0,0,0,0,0,0
blueberry,4.2,7,2,5,28,0,0,0,0,0,0,0,0
return_of_swamp_thing,0,4,2,2,50,0,0,0,0,0,0,0,0
the-return-of-the-musketeers,5.6,5,3,2,60,0,0,0,0,0,0,0,0
1017666-road_house,5.2,27,12,15,44,3.6,5,0,5,0,3.2,10370,68
romero,7.3,8,6,2,75,0,1,0,1,0,3.8,512,79
rosalie_goes_shopping,6.1,7,5,2,71,0,2,1,1,50,3.6,136,64
santa_sangre,6.8,18,14,4,77,6.6,5,4,1,80,4.1,2145,88
notes_on_a_scandal,7.5,167,145,22,86,8,36,33,3,91,3.7,22200,81
scenes_from_the_class_struggle_in_beverly_hills,5.8,5,4,1,80,0,1,0,1,0,3,268,38
sea_of_love,7,19,16,3,84,0,1,1,0,100,3.3,3334,62
see_no_evil_hear_no_evil,3.4,11,2,9,18,0,1,0,1,0,3.3,6015,72
shes_out_of_control,3,16,1,15,6,0,4,0,4,0,2.8,915,46
shirley_valentine,6.3,11,8,3,72,0,2,0,2,0,3.8,1235,85
shocker,3.4,12,1,11,8,0,0,0,0,0,0,0,0
1019128-skin_deep,4.8,12,5,7,41,0,1,1,0,100,3,517,49
slaves_of_new_york,2.9,8,1,7,12,0,1,0,1,0,3.2,287,58
some_girls,0,1,0,1,0,0,0,0,0,0,0,0,0
stepfather,6.5,26,22,4,84,6.6,5,3,2,60,3.4,1144,64
sweetie,7.1,12,11,1,91,0,1,1,0,100,3.6,538,72
tango_and_cash,4.3,33,13,20,39,0,3,0,3,0,3,9072,54
this_is_spinal_tap,8.6,53,51,2,96,7.7,7,6,1,85,3.9,23608,91
three_fugitives,3.9,13,2,11,15,0,0,0,0,0,0,0,0
troop_beverly_hills,3.2,12,1,11,8,0,2,0,2,0,2.6,2799,53
turner_and_hooch,5.2,21,13,8,61,0,0,0,0,0,0,0,0
uhf,5.5,22,12,10,54,0,1,0,1,0,3.2,7472,73
uncle_buck,5.8,17,9,8,52,0,1,0,1,0,3.2,13669,72
vampires_kiss,5.9,21,13,8,61,3.8,5,1,4,20,2.9,2172,48
war_of_the_roses,7,37,30,7,81,5.8,8,5,3,62,3.2,5702,64
warlock,5.3,15,8,7,53,0,1,0,1,0,3.1,2153,53
wizard,4.3,17,4,13,23,0,3,0,3,0,3.1,3783,60
worth_winning,0,4,0,4,0,0,0,0,0,0,0,0,0
warlock_the_armageddon,0,4,0,4,0,0,0,0,0,0,0,0,0
weekend_at_bernies_ii,2.5,28,3,25,10,3.7,5,2,3,40,0,0,0
billy_liar,7.6,9,9,0,100,0,1,1,0,100,4,754,82
black_robe,7,12,11,1,91,0,1,0,1,0,3.3,1641,60
cat_o_nine_tails,6.4,12,10,2,83,0,0,0,0,0,0,0,0
cotton_club,6.3,23,17,6,73,0,3,2,1,66,3.2,1978,53
defcon-41985,0,0,0,0,0,0,0,0,0,0,0,0,0
hotel_new_hampshire,6.1,13,9,4,69,0,0,0,0,0,0,0,0
idiot_box,0,3,1,2,33,0,0,0,0,0,0,0,0
left_luggage,5,11,4,7,36,0,3,1,2,33,4.1,417,89
wholl_stop_the_rain,6.8,7,5,2,71,0,0,0,0,0,0,0,0
zorro_the_gay_blade,4.8,14,6,8,42,0,1,0,1,0,3.2,1667,60
basket_case,6.3,16,12,4,75,0,0,0,0,0,0,0,0
original_sin,3.4,90,11,79,12,3.1,29,2,27,6,3.2,10609,67
princess_diaries,5.1,110,51,59,46,5.2,28,13,15,46,3.2,83951,71
rush_hour_2,5.4,125,64,61,51,5.1,33,17,16,51,3.3,64114,77
1103080-chocolat,6,114,71,43,62,6.1,32,20,12,62,3.6,62492,82
hatari,6.6,22,15,7,68,0,4,3,1,75,3.7,1953,75
la_cage_aux_folles,8,15,15,0,100,0,1,1,0,100,3.7,1639,79
la_cage_aux_folles_2,0,4,2,2,50,0,0,0,0,0,0,0,0
liebestraum,5.6,10,4,6,40,0,2,1,1,50,3.1,260,41
paint_your_wagon,4.7,13,3,10,23,0,1,0,1,0,3.4,1851,66
shootist,7.9,14,13,1,92,0,1,1,0,100,3.9,2835,84
theremin_an_electronic_odyssey,7.6,15,15,0,100,0,3,3,0,100,3.5,288,64
wild_child,8.4,25,25,0,100,8.5,9,9,0,100,3.7,996,78
altered_states,6.9,33,29,4,87,0,4,4,0,100,3.4,4339,66
any_which_way_you_can,4.9,10,2,8,20,0,1,0,1,0,3.1,3457,50
a-crude-awakening-the-oil-crash,6.5,14,11,3,78,0,1,0,1,0,4,969,85
1148372-bad_timing,6.9,5,3,2,60,0,1,0,1,0,3.7,926,79
1002306-big_brawl,5.1,6,4,2,66,0,0,0,0,0,0,0,0
american_pie,5.7,115,67,48,58,5.5,25,13,12,52,3.4,203348,63
osmosis_jones,5.5,106,57,49,53,5.5,29,16,13,55,2.8,7220,40
1109257-others,7.2,146,122,24,83,6.4,33,21,12,63,3.3,47632,75
american_outlaws,3.6,100,13,87,13,3,28,2,26,7,3.2,5353,69
all_over_the_guy,4.9,47,20,27,42,4.8,17,7,10,41,3.5,1303,67
deep_end,7.1,114,93,21,81,7.6,29,26,3,89,3.3,1107,58
session_9,6.2,63,38,25,60,4.7,17,6,11,35,3.4,5642,69
turandot_project,6.9,30,23,7,76,6.7,9,7,2,77,3.3,205,49
captain_corellis_mandolin,4.4,113,33,80,29,3.9,34,8,26,23,2.9,7435,51
rat_race,4.9,124,53,71,42,4.2,28,8,20,28,3.1,23720,63
aberdeen,7,38,33,5,86,8,12,12,0,100,3.7,511,77
1185734-innocence,6.7,17,11,6,64,6.9,8,6,2,75,3.7,1170,73
bubble_boy,3.8,81,24,57,29,3.8,19,5,14,26,2.8,14041,52
curse_of_the_jade_scorpion,5.2,122,55,67,45,5,36,14,22,38,3.1,4108,52
jay_and_silent_bob_strike_back,5.6,148,78,70,52,5.3,31,14,17,45,3.4,44787,77
ghosts-of-mars,3.6,100,19,81,19,3.4,22,4,18,18,2.4,6302,29
summer_catch,3.1,82,6,76,7,3,27,2,25,7,2.6,6249,44
1117045-rhapsody,0,0,0,0,0,0,0,0,0,0,0,0,0
happy_accidents,6.3,60,43,17,71,6.5,19,13,6,68,3.7,1489,77
lisa_picard_is_famous,5.4,41,18,23,43,5.5,13,7,6,53,3.1,356,40
maybe_baby,5.1,28,13,15,46,3.8,8,2,6,25,3.1,1495,50
1109600-together,7.2,79,71,8,89,7.6,26,25,1,96,4,2485,87
tortilla_soup,6.3,62,45,17,72,6,23,15,8,65,3.5,996,73
jeepers_creepers,5.1,107,48,59,44,4.8,26,10,16,38,2.9,22835,56
o,6,123,78,45,63,5.2,31,16,15,51,3,4986,58
waking_up_in_reno,3.6,37,5,32,13,3.8,9,2,7,22,2.9,1272,36
speedway_junky,4.4,6,2,4,33,0,3,1,2,33,3.2,549,52
3_ninjas,3.4,5,0,5,0,0,0,0,0,0,0,0,0
3_ninjas_kick_back,2.8,6,1,5,16,0,3,1,2,33,2.6,6654,39
3_ninjas_knuckle_up,0,3,0,3,0,0,0,0,0,0,0,0,0
1010230-hunter,4.8,9,4,5,44,0,1,0,1,0,3.2,898,53
maniac_1980,4.9,11,5,6,45,0,0,0,0,0,0,0,0
interview_with_the_vampire,5.8,45,26,19,57,4.6,10,4,6,40,3.7,77706,85
1023637-wicker_man,7.7,45,41,4,91,0,4,4,0,100,3.6,8988,79
wish_upon_a_star,0,3,1,2,33,0,0,0,0,0,0,0,0
1021340-three_musketeers,7.1,11,9,2,81,0,0,0,0,0,0,0,0
star2001,0,0,0,0,0,0,0,0,0,0,0,0,0
soul_survivors,2.6,47,2,45,4,2.3,11,0,11,0,2.6,2441,34
two_can_play_that_game,4.9,63,27,36,42,4.8,23,9,14,39,3.6,5802,82
bounce_behind_the_velvet_rope,5.2,10,4,6,40,0,4,2,2,50,2.9,339,36
diamond_men,7,62,50,12,80,7.1,20,17,3,85,3.2,367,49
iron_ladies,5.2,33,18,15,54,5.4,12,7,5,58,3.6,603,71
kill_me_later,4.2,20,5,15,25,5.4,6,3,3,50,3.6,530,68
1106648-lie,7,82,68,14,82,7.1,24,21,3,87,3.7,1868,77
our_lady_of_the_assassins,6.6,61,47,14,77,6.8,22,16,6,72,3.3,450,59
abbott_and_costello_meet_the_mummy,4.9,9,3,6,33,0,0,0,0,0,0,0,0
dr_mabuse_the_gambler,7.4,11,10,1,90,0,1,0,1,0,4.1,721,90
into_the_arms_of_strangers_stories_of_the_kindertransport,7.7,34,32,2,94,7.4,11,10,1,90,3.8,433,82
glass_house,4.2,84,18,66,21,4,20,4,16,20,2.8,7214,48
dinner_rush,7.1,44,40,4,90,7.7,13,13,0,100,3.8,853,80
haiku_tunnel,5.6,47,28,19,59,5.2,20,11,9,55,3.4,353,73
1109942-big_trouble,5.4,110,53,57,48,4.8,31,9,22,29,2.9,3336,52
glitter,2.8,85,6,79,7,2.7,27,1,26,3,2.1,7598,46
training_day,6.5,151,108,43,71,6.3,34,24,10,70,3.6,50545,85
1104332-american,0,0,0,0,0,0,0,0,0,0,0,0,0
children_underground,7.5,17,16,1,94,7.6,7,7,0,100,4.2,389,89
go_tigers,7.1,39,33,6,84,7.1,14,13,1,92,3.3,227,63
taken,5.8,160,92,68,57,5.2,33,14,19,42,4,307912,83
megiddo_the_omega_code_ii,3.1,19,2,17,10,2.5,7,0,7,0,3.1,612,51
1110008-sidewalks_of_new_york,5.5,91,51,40,56,5.4,24,12,12,50,3.1,1120,50
the-endurance,7.7,65,62,3,95,7.9,24,24,0,100,3.8,415,79
french_lieutenants_woman,7.1,15,11,4,73,0,1,1,0,100,3.5,1859,67
legend_of_hell_house,5.7,13,6,7,46,0,1,0,1,0,3.3,1221,61
little_man_tate,6.2,23,18,5,78,0,2,1,1,50,3.2,2824,62
moscow_does_not_believe_in_tears,0,3,1,2,33,0,0,0,0,0,0,0,0
phantom_of_the_paradise,7.6,15,14,1,93,0,3,2,1,66,3.9,3007,81
return_of_a_man_called_horse,5.7,7,5,2,71,0,1,0,1,0,3.2,576,54
valdez_is_coming,0,1,1,0,100,0,0,0,0,0,0,0,0
thirteen_ghosts,3.4,89,11,78,12,3.4,22,3,19,13,3,20700,60
montenegro,7,12,11,1,91,0,3,2,1,66,3.6,259,71
1016240-phantom_of_the_opera,7.9,33,29,4,87,5.8,7,4,3,57,3.7,6169,77
father_goose,6.3,12,9,3,75,0,0,0,0,0,0,0,0
grass_is_greener,6.6,7,7,0,100,0,0,0,0,0,0,0,0
1009736-hole_in_the_head,6.2,5,4,1,80,0,0,0,0,0,0,0,0
1010540-indiscreet,7.2,8,8,0,100,0,0,0,0,0,0,0,0
its_a_mad_mad_mad_mad_world,6.7,26,20,6,76,0,3,2,1,66,3.6,5290,79
1011638-king_solomons_mines,7.4,11,10,1,90,0,0,0,0,0,0,0,0
little_foxes,8.5,14,14,0,100,0,0,0,0,0,0,0,0
operation_petticoat,6.6,11,9,2,81,0,0,0,0,0,0,0,0
play_misty_for_me,7.3,30,25,5,83,7.3,5,4,1,80,3.5,2914,70
pocketful_of_miracles,5.8,8,5,3,62,0,0,0,0,0,0,0,0
sayonara,7.2,9,9,0,100,0,0,0,0,0,0,0,0
shop_on_main_street,8.9,12,12,0,100,0,0,0,0,0,0,0,0
1183674-hunting_party,6,89,47,42,52,5.8,26,12,14,46,3.4,13820,67
1042295-vanishing,4.8,33,15,18,45,4,6,1,5,16,3.1,3338,51
silkwood,7,22,16,6,72,0,3,1,2,33,3.7,2741,78
i_never_promised_you_a_rose_garden,0,3,2,1,66,0,1,1,0,100,3.3,304,50
quadrophenia,7.2,5,5,0,100,0,0,0,0,0,0,0,0
space_camp,4.8,10,4,6,40,0,1,0,1,0,2.9,2441,46
when_worlds_collide,5.9,19,15,4,78,0,3,2,1,66,3.4,786,64
dont_say_a_word,4.4,112,26,86,23,4.6,30,10,20,33,3,6502,55
hearts_in_atlantis,5.7,133,65,68,48,5.3,30,13,17,43,3.3,4981,64
zoolander,5.9,127,79,48,62,6.1,29,18,11,62,3.3,107651,78
born_romantic,5.5,31,18,13,58,5.3,9,5,4,55,3.3,588,56
extreme_days,4.4,7,3,4,42,0,1,1,0,100,3.9,1488,85
go-figure,0,0,0,0,0,0,0,0,0,0,0,0,0
wont_anybody_listen,0,3,2,1,66,0,1,1,0,100,0,0,0
joy_ride,6.6,111,82,29,73,6.7,29,23,6,79,3.1,9370,63
max_keebles_big_move,4.2,54,14,40,25,4,18,4,14,22,2.7,2400,42
serendipity,5.7,128,74,54,57,5.8,31,19,12,61,3.4,43975,79
grateful_dawg,6.2,43,30,13,69,6.8,19,15,4,78,3.6,223,69
cienaga,6.9,36,31,5,86,6.6,13,11,2,84,3.8,474,80
big_red_one,7.7,44,40,4,90,7.3,13,11,2,84,3.6,2424,74
boogeyman,3.4,85,11,74,12,3.2,11,0,11,0,2.5,13866,38
lady_in_a_cage,4.3,5,1,4,20,0,0,0,0,0,0,0,0
brubaker,6.9,18,15,3,83,0,1,0,1,0,3.5,1436,73
cant_stop_the_music,2.3,13,1,12,7,0,2,0,2,0,2.7,850,38
1003617-carny,0,4,3,1,75,0,1,0,1,0,3.3,264,53
1191742_changeling,6.3,190,117,73,61,5.6,39,17,22,43,3.8,63438,84
cheech_and_chongs_next_movie,0,1,1,0,100,0,0,0,0,0,0,0,0
coal_miners_daughter,8.1,10,10,0,100,0,1,1,0,100,3.6,6330,80
competition,6.6,5,4,1,80,0,1,1,0,100,3.5,116,56
cruising,5.3,27,16,11,59,0,3,3,0,100,3.2,1790,52
doa_dead_or_alive,4.5,44,15,29,34,4.2,10,2,8,20,2.7,71044,43
death_ship,0,3,1,2,33,0,0,0,0,0,0,0,0
last_metro,7.3,17,15,2,88,0,2,1,1,50,3.9,1300,82
divine-madness,0,0,0,0,0,0,0,0,0,0,0,0,0
dogs_of_war,6.2,9,8,1,88,0,0,0,0,0,0,0,0
learning_curve,4.3,10,2,8,20,0,3,0,3,0,3.1,147,50
bandits,6.1,136,86,50,63,5.9,34,20,14,58,3.1,9238,56
corky_romano,2.8,81,4,77,4,2.5,24,1,23,4,2.4,4219,42
1075984-iron_monkey,7.3,90,81,9,90,7.5,25,24,1,96,3.7,3899,83
fat_girl,6.4,83,60,23,72,7.4,26,23,3,88,3.4,1800,63
mulholland_dr,7.4,150,122,28,81,7.6,33,29,4,87,3.7,36399,88
my_first_mister,5.6,79,42,37,53,5.1,24,11,13,45,3.6,1032,74
spriggan,5.6,13,7,6,53,0,1,0,1,0,3.4,1591,67
things_behind_the_sun,7,10,10,0,100,0,1,1,0,100,3.7,309,76
bones,3.8,65,14,51,21,3.8,22,5,17,22,2.7,3184,47
brannigan,4.6,5,1,4,20,0,1,0,1,0,3.1,1032,48
clambake,0,0,0,0,0,0,0,0,0,0,0,0,0
dirty_harry,7.8,42,40,2,95,6.2,5,4,1,80,3.8,17350,86
destiny-in-space,0,0,0,0,0,0,0,0,0,0,0,0,0
fiddler_on_the_roof,7.8,24,21,3,87,0,2,2,0,100,3.8,10462,87
hail-columbia,0,0,0,0,0,0,0,0,0,0,0,0,0
kansas_city,5.9,33,19,14,57,6.2,9,5,4,55,3,608,37
making_the_grade,0,1,0,1,0,0,0,0,0,0,0,0,0
mission-to-mir-imax,0,0,0,0,0,0,0,0,0,0,0,0,0
not_without_my_daughter,4.9,14,7,7,50,0,2,1,1,50,3.4,2771,72
female_trouble,6.6,19,15,4,78,0,1,1,0,100,4,2218,84
titanica,6,5,3,2,60,0,1,1,0,100,3.2,184,49
from_hell,5.7,146,83,63,56,5.3,33,17,16,51,3.3,33233,70
last_castle,5.6,113,59,54,52,5.6,27,14,13,51,3.4,9259,73
riding_in_cars_with_boys,5.2,107,51,56,47,4.6,31,11,20,35,3.1,12761,63
bangkok_dangerous,3.4,92,8,84,8,3.3,15,1,14,6,2.8,23793,33
burnt_money,6.5,29,22,7,75,6.9,13,11,2,84,3.8,917,78
dancing_at_the_blue_iguana,4.6,22,5,17,22,5.6,5,2,3,40,3,698,44
auto_focus,6.7,155,112,43,72,6.9,37,28,9,75,3.2,1283,56
1110561-intimacy,6.2,68,44,24,64,6.4,22,16,6,72,3.3,918,58
waking_life,7.4,137,109,28,79,7.6,32,26,6,81,4,17715,87
kpax,5.1,136,55,81,40,5.1,32,14,18,43,3.2,14543,73
1110294-on_the_line,3.5,68,12,56,17,3.7,21,6,15,28,2.8,1493,50
thirteen_ghosts,3.4,89,11,78,12,3.4,22,3,19,13,3,20700,60
love_and_sex,5.2,48,23,25,47,5.2,12,6,6,50,3.7,1847,76
donnie_darko,7.5,103,87,16,84,6.7,16,10,6,62,3.1,208768,77
high_heels_and_low_lifes,4.3,30,6,24,20,4.9,5,2,3,40,3.1,929,47
life_as_a_house,5.2,102,47,55,46,4.5,30,9,21,30,3.8,11735,88
man_who_wasnt_there,7.1,152,122,30,80,6.8,32,23,9,71,3.7,10358,81
town_is_quiet,6.7,35,25,10,71,6.7,11,7,4,63,3.7,242,71
trembling-before-gd,7.1,61,54,7,88,7.2,19,18,1,94,3.4,564,64
domestic_disturbance,4,97,23,74,23,4.1,25,5,20,20,2.9,4637,45
monsters_inc,7.9,165,157,8,95,7.1,33,29,4,87,3.8,150109,83
the-one,3.9,83,11,72,13,3.9,22,4,18,18,3.1,16192,60
tape,6.7,90,69,21,76,6.8,24,18,6,75,3.6,2260,75
1109137-heist,6.2,125,82,43,65,6.3,30,18,12,60,3.2,3156,59
shallow_hal,5.4,118,59,59,50,5,29,13,16,44,3,34183,52
when_a_stranger_calls,3.2,88,8,80,9,3.1,14,1,13,7,3.1,53427,55
timerider-the-adventure-of-lyle-swann,0,0,0,0,0,0,0,0,0,0,0,0,0
1110236-wash,2.9,50,4,46,8,2.7,16,1,15,6,3.4,3029,65
harry_potter_and_the_sorcerers_stone,7,183,143,40,78,6.7,40,30,10,75,3.6,181305,81
novocaine,4.6,105,39,66,37,4.5,29,9,20,31,2.8,1635,37
black_knight,3.4,94,12,82,12,3.8,27,6,21,22,2.6,9124,46
out_cold,2.9,48,4,44,8,3,15,1,14,6,3.5,7234,84
spy_game,6.2,128,83,45,64,6.6,29,20,9,68,3.3,15479,70
devils_backbone,7.5,100,92,8,92,7.4,25,23,2,92,3.9,9276,89
in_the_bedroom,7.9,137,128,9,93,7.6,31,28,3,90,3.7,4252,79
hell_up_in_harlem,4.2,8,1,7,12,0,0,0,0,0,0,0,0
across_110th_street,0,4,4,0,100,0,0,0,0,0,0,0,0
petit_soldat,6.4,10,7,3,70,0,2,1,1,50,3.7,817,76
incredible_shrinking_woman,4,5,0,5,0,0,3,0,3,0,3,943,51
katie_tippel,0,3,2,1,66,0,1,0,1,0,2.9,32,29
jabberwocky,5.8,12,7,5,58,0,0,0,0,0,0,0,0
funny_girl,7.6,38,35,3,92,6.7,9,7,2,77,3.7,3850,81
breathless,8.6,48,46,2,95,8.1,12,11,1,91,4.2,10327,90
beastmaster,5.3,10,5,5,50,0,0,0,0,0,0,0,0
midway,5.9,11,6,5,54,0,1,0,1,0,3.6,1581,72
macarthur,5.4,8,5,3,62,0,0,0,0,0,0,0,0
young_lions,7.6,5,4,1,80,0,0,0,0,0,0,0,0
subway,5.8,7,6,1,85,0,0,0,0,0,0,0,0
now_voyager,8,19,17,2,89,0,0,0,0,0,0,0,0
1190049-little_women,0,0,0,0,0,0,0,0,0,0,0,0,0
guadalcanal_diary,0,2,1,1,50,0,0,0,0,0,0,0,0
anzio,6.1,6,4,2,66,0,1,1,0,100,3.1,972,43
cheap_detective,5.7,12,6,6,50,0,0,0,0,0,0,0,0
everybodys_famous,5.3,52,28,24,53,5,21,11,10,52,3.4,535,58
last_wave,7.4,15,13,2,86,0,1,0,1,0,3.7,913,79
that_obscure_object_of_desire,9,25,25,0,100,0,3,3,0,100,4.1,2049,90
toy_story,9,73,73,0,100,8.5,17,17,0,100,3.7,102338,81
funeral_in_berlin,5.9,7,5,2,71,0,0,0,0,0,0,0,0
dont_go_in_the_house,0,3,0,3,0,0,0,0,0,0,0,0,0
earthling,0,0,0,0,0,0,0,0,0,0,0,0,0
exterminator,0,3,0,3,0,0,0,0,0,0,0,0,0
darkness_falls,3.2,124,10,114,8,3,25,1,24,4,2.8,11135,46
fame,6.9,28,22,6,78,0,4,2,2,50,3.2,6724,67
fatso,0,3,2,1,66,0,0,0,0,0,0,0,0
aviators_wife,7.3,6,6,0,100,0,3,3,0,100,3.6,300,79
final_countdown,5.5,10,5,5,50,0,1,0,1,0,3.4,1797,64
first_deadly_sin,5.9,7,4,3,57,0,1,1,0,100,3,424,33
1007517-flash_gordon,6.3,32,26,6,81,0,3,2,1,66,3.1,6492,64
angry_red_planet,4,6,0,6,0,0,0,0,0,0,0,0,0
at_the_earths_core,4.4,6,2,4,33,0,1,0,1,0,2.9,800,35
empire_of_the_ants,2.4,16,0,16,0,0,2,0,2,0,2.7,618,29
1006646-enforcer,6.3,26,20,6,76,0,1,1,0,100,3.4,3350,61
1101753-eye,0,0,0,0,0,0,0,0,0,0,0,0,0
gauntlet,6.1,16,13,3,81,0,1,1,0,100,3.2,2342,53
i_bury_the_living,6.3,10,6,4,60,0,0,0,0,0,0,0,0
1010685-invasion_usa,4,10,3,7,30,0,1,0,1,0,3,1237,51
lone_wolf_mcquade,0,3,2,1,66,0,1,1,0,100,3.4,1315,69
morons_from_outer_space,0,3,1,2,33,0,0,0,0,0,0,0,0
people_that_time_forgot,0,3,1,2,33,0,0,0,0,0,0,0,0
oceans_eleven,6.9,166,135,31,81,7.2,33,28,5,84,3.6,185259,76
sicilian,4.2,8,1,7,12,0,1,0,1,0,2.9,708,42
sudden_impact,5.7,32,19,13,59,0,4,3,1,75,3.2,4154,56
1111645-behind_enemy_lines,4.7,127,46,81,36,4.7,30,12,18,40,3.3,24612,65
independent,6,48,29,19,60,6.3,13,9,4,69,3,404,46
porn_star_the_legend_of_ron_jeremy,6,47,32,15,68,5.5,17,8,9,47,3.3,1190,61
oceans_eleven,6.9,166,135,31,81,7.2,33,28,5,84,3.6,185259,76
baran,7.6,63,56,7,88,8,21,20,1,95,3.9,880,87
business_of_strangers,6.5,91,72,19,79,7.3,29,27,2,93,3.1,808,49
incredible_shrinking_man,7.6,16,14,2,87,0,2,1,1,50,3.7,997,80
no_mans_land,7.8,97,90,7,92,8.2,24,23,1,95,4.1,3608,92
pinero,5.4,61,26,35,42,5.3,22,10,12,45,3.7,301,70
and_then_there_were_none,8,11,11,0,100,0,0,0,0,0,0,0,0
1002681-blue_angel,8.3,32,30,2,93,7.9,9,9,0,100,4,1414,85
moscow_on_the_hudson,7,13,12,1,92,0,1,1,0,100,3,1498,48
1015844-owl_and_the_pussycat,6.5,10,8,2,80,0,0,0,0,0,0,0,0
amelie,7.9,140,126,14,90,7.5,28,24,4,85,4.2,149167,95
not_another_teen_movie,4,94,26,68,27,4.4,22,7,15,31,3,48724,60
vanilla_sky,5.2,160,63,97,39,4.4,33,8,25,24,3,44021,68
1111227-iris,7.1,109,86,23,78,7.6,34,29,5,85,3.6,2908,73
kandahar,7.6,96,85,11,88,8,31,31,0,100,3.6,1057,74
lantana,7.4,103,93,10,90,7.8,30,28,2,93,3.8,1926,81
royal_tenenbaums,7.2,170,135,35,79,6.7,36,27,9,75,3.6,56830,87
bill_and_teds_bogus_journey,6,33,19,14,57,6,6,4,2,66,3,17201,59
clockwise,0,4,3,1,75,0,0,0,0,0,0,0,0
crawling_eye,5.1,7,4,3,57,0,0,0,0,0,0,0,0
holcroft_covenant,0,2,1,1,50,0,0,0,0,0,0,0,0
morgan,7.3,6,6,0,100,0,0,0,0,0,0,0,0
sheena,4.2,8,3,5,37,0,0,0,0,0,0,0,0
spacehunter_adventures_in_the_forbidden_zone,3.2,5,1,4,20,0,0,0,0,0,0,0,0
white_water_summer,4.5,6,2,4,33,0,0,0,0,0,0,0,0
how_high,3.8,56,15,41,26,4.4,19,7,12,36,3.5,15720,80
jimmy_neutron_boy_genius,6.4,73,54,19,73,6.1,17,11,6,64,2.7,5010,42
some_body,4.5,30,12,18,40,5.5,11,6,5,54,0,0,0
kate_and_leopold,5.2,116,55,61,47,5.2,30,13,17,43,3,23394,64
lord_of_the_rings_the_fellowship_of_the_ring,8.1,202,186,16,92,7.9,38,35,3,92,4.1,282006,92
majestic,4.9,135,56,79,41,4,30,8,22,26,3.1,10091,60
beautiful_mind,7.1,180,140,40,77,7.2,37,30,7,81,3.9,103150,91
little_otik,7,42,35,7,83,6.6,8,6,2,75,3.9,1648,84
1111079-convent,0,2,1,1,50,0,0,0,0,0,0,0,0
defiant_ones,7,14,12,2,85,0,2,2,0,100,3.7,1030,85
dodsworth,7.5,15,13,2,86,0,3,3,0,100,4,490,82
medium_cool,8.1,18,17,1,94,0,2,2,0,100,3.7,656,75
1144274-sahara,5.2,171,66,105,38,5,34,15,19,44,3,24489,61
fritz_the_cat,5.4,18,10,8,55,0,2,1,1,50,3.3,1651,64
nine_lives_of_fritz_the_cat,5.7,7,3,4,42,0,0,0,0,0,0,0,0
manchester-fiesta-part-1,0,0,0,0,0,0,0,0,0,0,0,0,0
1018587-separate_tables,8.1,11,10,1,90,0,0,0,0,0,0,0,0
sex-and-zen,0,0,0,0,0,0,0,0,0,0,0,0,0
topkapi,7.4,18,15,3,83,0,3,3,0,100,0,0,0
ali,6.3,145,97,48,66,6.5,34,25,9,73,3.3,18871,65
black_hawk_down,6.9,156,119,37,76,6.5,34,25,9,73,3.7,83816,85
charlotte_gray,4.7,87,27,60,31,5,32,11,21,34,3.4,2092,62
yentl,6,14,10,4,71,0,1,1,0,100,3.4,1678,72
gosford_park,7.5,141,121,20,85,8.1,30,29,1,96,3.5,10122,76
i_am_sam,4.6,141,47,94,33,4.7,38,14,24,36,3.7,51459,87
monsters_ball,7.4,141,120,21,85,7.1,38,30,8,78,3.3,12025,65
shipping_news,5.8,128,71,57,55,5.8,32,18,14,56,3.2,4197,62
1002332-big_heat,8.4,25,25,0,100,8.6,5,5,0,100,0,0,0
motorama,5.1,5,3,2,60,0,0,0,0,0,0,0,0
queen_bee,0,4,2,2,50,0,0,0,0,0,0,0,0
silent_trigger,0,4,1,3,25,0,0,0,0,0,0,0,0
murder_by_death,6.1,16,11,5,68,0,3,2,1,66,3.9,3635,84
servant,6.6,16,12,4,75,0,3,1,2,33,4.1,746,92
waterdance,7.2,13,12,1,92,0,2,2,0,100,3.3,417,56
come_undone,0,0,0,0,0,0,0,0,0,0,0,0,0
orange_county,5.2,119,56,63,47,5.2,29,13,16,44,3,12865,61
brotherhood_of_the_wolf,6.2,115,82,33,71,6,30,21,9,70,3.5,10900,76
another_48_hrs,3.8,20,4,16,20,0,2,0,2,0,2.9,6166,41
what_time_is_it_there,7.1,50,42,8,84,7.4,17,15,2,88,3.9,860,81
china_moon,5.6,9,4,5,44,0,1,0,1,0,3,535,35
good_wife,0,4,2,2,50,0,1,0,1,0,2.9,207,23
failure_to_launch,4.6,147,37,110,25,5.2,33,13,20,39,3.2,86609,60
russia_house,6.6,14,10,4,71,0,2,1,1,50,3,1792,42
truly_madly_deeply,6.6,32,23,9,71,6.9,6,5,1,83,3.9,3004,82
1024192-wuthering_heights,7.9,16,16,0,100,0,1,1,0,100,3.9,2525,84
california_suite,5.2,19,11,8,57,0,2,0,2,0,3.1,671,47
long_gray_line,7.1,5,5,0,100,0,0,0,0,0,0,0,0
flight_of_dragons,0,0,0,0,0,0,0,0,0,0,0,0,0
dragonslayer,6.1,22,18,4,81,0,1,1,0,100,3.2,8214,59
the-destroyer,0,0,0,0,0,0,0,0,0,0,0,0,0
fire-ice-the-dragon-chronicles,0,0,0,0,0,0,0,0,0,0,0,0,0
spacehunter_adventures_in_the_forbidden_zone,3.2,5,1,4,20,0,0,0,0,0,0,0,0
formula_17,4.8,9,2,7,22,5.2,5,2,3,40,3.6,656,70
foxes,5.9,9,6,3,66,0,1,1,0,100,3.3,658,55
galaxina,3.6,5,1,4,20,0,0,0,0,0,0,0,0
impostor,3.9,91,19,72,20,3.6,25,4,21,16,3,1418,46
kung_pow,2.8,53,6,47,11,2.8,12,0,12,0,3,15128,64
snow_dogs,3.9,79,18,61,22,3.5,18,3,15,16,2.8,11502,55
48_hrs,7.4,33,31,2,93,0,4,3,1,75,3.2,10471,61
farewell,6.5,14,10,4,71,0,4,4,0,100,2.8,129,30
italian_for_beginners,7.2,81,71,10,87,7.5,26,23,3,88,3.7,1581,77
time-of-favor,6.1,24,14,10,58,6.9,11,9,2,81,3.6,197,71
blankman,3.3,15,2,13,13,0,3,1,2,33,2.3,2988,32
1003017-brainstorm,5.8,14,9,5,64,0,1,0,1,0,3.1,1295,54
dragon_the_bruce_lee_story,6.8,17,14,3,82,0,3,1,2,33,3.4,7771,76
mystery-of-kaspar-hauser-jeder-fur-sich-und-gott-gegen-alle,0,0,0,0,0,0,0,0,0,0,0,0,0
4_for_texas,4.1,8,1,7,12,0,0,0,0,0,0,0,0
heart-of-glass,7.2,7,6,1,85,0,2,1,1,50,3.7,892,71
little_dieter_needs_to_fly,7.8,14,13,1,92,0,4,3,1,75,4.1,1132,93
mash,8.2,35,31,4,88,0,4,3,1,75,3.7,10200,81
1014352-mrs_soffel,5.6,9,5,4,55,0,2,0,2,0,3.1,791,41
1097865-gone_in_60_seconds,4.4,133,32,101,24,4,35,8,27,22,3.5,92563,79
oneeyed_jacks,6.3,12,7,5,58,0,0,0,0,0,0,0,0
1110288-count_of_monte_cristo,6.6,134,99,35,73,6.3,27,18,9,66,3.6,29907,85
mothman_prophecies,5.5,133,69,64,51,4.8,31,9,22,29,3,8350,58
walk_to_remember,4.1,101,28,73,27,4.1,25,6,19,24,3.3,243778,79
american_adobo,4.6,23,7,16,30,5,9,4,5,44,3.8,502,71
beijing_bicycle,6.4,58,36,22,62,6.3,18,11,7,61,3.6,1036,75
escaflowne_the_movie,5.3,14,6,8,42,0,4,3,1,75,3.6,2839,73
maelstroem,6.7,35,28,7,80,6.6,11,9,2,81,4,14,100
1013775-metropolis,8.9,98,97,1,98,8.8,23,23,0,100,4.1,17640,90
sons_room,7.3,81,68,13,83,7.6,28,25,3,89,3.8,1513,80
storytelling,5.6,89,47,42,52,5.8,27,15,12,55,3.5,3033,69
waydowntown,6.4,33,23,10,69,6.4,7,5,2,71,3.5,496,70
adventures_of_huck_finn,5.9,13,8,5,61,0,4,3,1,75,2.9,2408,47
cousins,5.8,8,4,4,50,0,1,1,0,100,3.1,644,57
falling_in_love,5.4,10,6,4,60,0,1,0,1,0,3.5,2067,67
youngheart,7.5,97,85,12,87,7.7,23,21,2,91,4.2,3340,91
slackers,3.1,104,11,93,10,2.4,30,1,29,3,2.8,4294,52
birthday_girl,5.7,120,69,51,57,5.5,30,16,14,53,2.8,4145,40
a-rumor-of-angels,4.7,29,10,19,34,4.7,9,3,6,33,3.6,355,74
rare_birds,5.9,12,7,5,58,0,4,1,3,25,3.4,569,61
caged_heat,6.4,9,7,2,77,0,1,0,1,0,2.9,988,37
carmen_jones,6.1,18,13,5,72,0,3,2,1,66,3.9,1003,80
five_heartbeats,4.9,14,6,8,42,0,2,1,1,50,4.2,4599,93
get_out_your_handkerchiefs,6.6,9,8,1,88,0,0,0,0,0,0,0,0
going_places,6.9,6,5,1,83,0,0,0,0,0,0,0,0
honky_tonk_freeway,0,2,2,0,100,0,0,0,0,0,0,0,0
1073312-hunchback_of_notre_dame,0,0,0,0,0,0,0,0,0,0,0,0,0
le-magnifique,0,0,0,0,0,0,0,0,0,0,0,0,0
big_fat_liar,4.9,88,38,50,43,4.5,21,7,14,33,2.9,23120,52
1110242-collateral_damage,4,139,24,115,17,3.9,30,6,24,20,2.8,10885,34
1017814-rollerball,6,25,17,8,68,0,4,1,3,25,3.2,2655,61
scotland_pa,6,74,44,30,59,5.3,27,11,16,40,3.6,1222,74
babys_day_out,3.9,14,3,11,21,0,3,0,3,0,2.7,10709,54
bright_eyes,6.4,8,6,2,75,0,0,0,0,0,0,0,0
1005868-dimples,0,2,1,1,50,0,0,0,0,0,0,0,0
1009439-heidi,0,0,0,0,0,0,0,0,0,0,0,0,0
1040103-man_who_loved_women,7,9,8,1,88,0,2,2,0,100,3.9,1035,83
richard_pryor_here_and_now,7.5,6,5,1,83,0,1,1,0,100,3.7,646,83
rookie_of_the_year,4.7,17,6,11,35,0,2,1,1,50,0,0,0
sandlot,5.8,22,13,9,59,0,3,2,1,66,3.6,28919,86
vacas,0,2,0,2,0,0,0,0,0,0,0,0,0
dont_look_now,8.2,37,35,2,94,6.6,8,7,1,87,3.8,4354,80
1112549-crossroads,3.9,101,14,87,13,3.9,24,3,21,12,2.2,15071,41
harts_war,5.9,117,68,49,58,5.6,32,17,15,53,3,6114,52
john_q,4.4,127,28,99,22,4,33,4,29,12,3.6,18865,83
return_to_never_land,5.4,89,41,48,46,6.3,22,15,7,68,3.2,4974,54
super_troopers,5,86,31,55,36,5.1,20,8,12,40,3.7,49372,89
good_son,4.2,24,6,18,25,3.9,8,2,6,25,3,6435,58
last_orders,7,88,69,19,78,7.4,28,23,5,82,3.4,644,64
after_the_fox,5.4,7,5,2,71,0,0,0,0,0,0,0,0
bad_and_the_beautiful,7.7,13,13,0,100,0,1,1,0,100,3.8,1035,83
cast_a_giant_shadow,0,3,1,2,33,0,0,0,0,0,0,0,0
designing_woman,7,8,6,2,75,0,0,0,0,0,0,0,0
funny_lady,4.4,7,2,5,28,0,1,0,1,0,3.2,1039,59
the_heartbreak_kid,4.7,153,47,106,30,4.6,32,9,23,28,2.9,91228,41
saturday_night_and_sunday_morning,8,10,10,0,100,0,0,0,0,0,0,0,0
sleuth,5.1,118,42,76,35,5.1,30,10,20,33,3.2,9724,53
stroszek,8.2,13,13,0,100,0,3,3,0,100,4.3,1933,93
summer_of_42,6.7,16,13,3,81,0,1,0,1,0,3.6,580,78
touch_of_class,6.8,10,9,1,90,0,1,1,0,100,3,669,46
town_without_pity,6,5,3,2,60,0,0,0,0,0,0,0,0
used_cars,6.5,17,13,4,76,0,1,0,1,0,3.3,1611,63
deadly_mantis,4.2,8,2,6,25,0,0,0,0,0,0,0,0
dragonfly,3.6,121,8,113,6,3.5,30,1,29,3,3.1,9426,65
queen_of_the_damned,3.9,126,21,105,16,3.9,31,5,26,16,3.1,36894,70
big_bad_love,5.4,58,24,34,41,5.3,20,7,13,35,3.7,279,74
green_dragon,5.9,28,17,11,60,6.3,9,6,3,66,3.1,559,40
how_to_kill_your_neighbors_dog,6,31,18,13,58,5.5,9,4,5,44,3.7,569,70
1050388-last_man_on_earth,6.3,15,11,4,73,0,1,0,1,0,3.6,4886,69
maryam,6.8,34,26,8,76,7.1,12,10,2,83,3.8,36,83
1114210-mean_machine,4.9,56,19,37,33,5.4,21,9,12,42,3.5,6547,76
monsoon_wedding,7.9,116,110,6,94,8,35,33,2,94,3.8,5868,85
wendigo,6.2,50,29,21,58,5.9,13,6,7,46,2.4,773,27
state_property,2,12,0,12,0,0,3,0,3,0,3.7,1134,75
interlude,0,0,0,0,0,0,0,0,0,0,0,0,0
bad_news_bears_go_to_japan,2.9,10,0,10,0,0,0,0,0,0,0,0,0
bad_news_bears_in_breaking_training,6,8,4,4,50,0,0,0,0,0,0,0,0
firemens_ball,7.7,16,14,2,87,0,1,1,0,100,3.9,578,83
lone_ranger_and_the_lost_city_of_gold,0,4,2,2,50,0,0,0,0,0,0,0,0
loves_of_a_blonde,8,13,12,1,92,0,0,0,0,0,0,0,0
vampire_hunter_d_bloodlust,6.4,32,23,9,71,6.3,12,8,4,66,3.8,11019,83
wild_strawberries,8.8,31,29,2,93,0,2,1,1,50,4.4,6409,94
black_like_me,0,0,0,0,0,0,0,0,0,0,0,0,0
cattle_queen_of_montana,0,1,1,0,100,0,0,0,0,0,0,0,0
under_the_skin,6.8,22,19,3,86,7.7,9,9,0,100,3.4,239,67
40_days_and_40_nights,4.8,134,51,83,38,4.5,34,9,25,26,3.1,33188,53
we_were_soldiers,6.4,141,88,53,62,6.9,36,27,9,75,3.6,36901,84
trouble_every_day,5.6,45,20,25,44,4.5,11,3,8,27,3.5,756,63
1033999-arena,0,0,0,0,0,0,0,0,0,0,0,0,0
big_bird_cage,0,3,3,0,100,0,0,0,0,0,0,0,0
big_doll_house,0,4,4,0,100,0,0,0,0,0,0,0,0
1029529-church,5.8,9,6,3,66,0,0,0,0,0,0,0,0
cross_creek,5.4,10,6,4,60,0,2,1,1,50,3.4,269,59
ferngully_the_last_rainforest,6.3,13,9,4,69,0,1,1,0,100,3.1,10187,62
night-of-the-zombies-battalion-of-the-living-deadgamma-693the-chillingsister-of-death,0,0,0,0,0,0,0,0,0,0,0,0,0
intersection,3.4,27,2,25,7,3.1,8,0,8,0,2.8,1105,40
jo_jo_dancer_your_life_is_calling,5.6,11,6,5,54,0,1,1,0,100,3.4,747,66
deliria-bloody-birdsound-stage-massacrestage-fright,0,2,1,1,50,0,0,0,0,0,0,0,0
a-troll-in-central-park,3.1,5,0,5,0,0,0,0,0,0,0,0,0
zombie,4.6,14,5,9,35,0,0,0,0,0,0,0,0
my_favorite_brunette,5.9,7,5,2,71,0,0,0,0,0,0,0,0
royal_wedding,6.7,14,12,2,85,0,0,0,0,0,0,0,0
scarlet_street,8,11,11,0,100,0,0,0,0,0,0,0,0
all_about_the_benjamins,4.3,75,22,53,29,4.2,21,6,15,28,3.4,6169,77
1112951-time_machine,4.8,146,41,105,28,5,32,6,26,18,2.7,10389,45
full_frontal,5.2,140,52,88,37,5.2,35,12,23,34,2.6,1893,27
divorcing-jack,0,0,0,0,0,0,0,0,0,0,0,0,0
1034131-field,5.2,14,6,8,42,3.3,6,1,5,16,3.8,615,80
1032750-hidden_agenda,6.6,18,14,4,77,6.5,5,4,1,80,3.7,279,75
luminarias,6.1,15,10,5,66,0,2,0,2,0,3.1,147,43
1013071-magnificent_ambersons,8.4,23,22,1,95,7.6,6,6,0,100,4.1,1662,86
hes_just_not_that_into_you,5.2,152,64,88,42,5,37,12,25,32,3.4,219066,60
1085275-gloria,4.1,27,5,22,18,5.1,6,1,5,16,2.7,660,31
the-great-rocknroll-swindle,6.9,6,6,0,100,0,0,0,0,0,0,0,0
hangar_18,0,3,1,2,33,0,0,0,0,0,0,0,0
hawk_the_slayer,0,3,1,2,33,0,0,0,0,0,0,0,0
he_knows_youre_alone,4.8,5,1,4,20,0,0,0,0,0,0,0,0
heavens_gate,5,20,9,11,45,0,3,1,2,33,3.1,1241,52
hero_at_large,0,0,0,0,0,0,0,0,0,0,0,0,0
honeysuckle_rose,0,4,3,1,75,0,1,1,0,100,3.9,189,78
hopscotch,6.1,12,9,3,75,0,1,1,0,100,3.6,761,72
inside_moves,0,2,1,1,50,0,0,0,0,0,0,0,0
island,5.4,184,74,110,40,5.2,36,14,22,38,3.3,41199,67
1010979-jazz_singer,3.7,20,3,17,15,0,3,1,2,33,3.4,857,71
ko-to-tamo-peva-who-sings-over-there,0,0,0,0,0,0,0,0,0,0,0,0,0
zombie_lake,0,2,0,2,0,0,0,0,0,0,0,0,0
lion_of_the_desert,0,4,3,1,75,0,0,0,0,0,0,0,0
little_darlings,0,4,3,1,75,0,1,0,1,0,3.4,1497,71
long_good_friday,8.1,20,19,1,95,0,3,3,0,100,4.1,2936,88
long_riders,6.4,19,15,4,78,0,2,0,2,0,3.5,1258,71
the-man-who-saw-tomorrow,0,0,0,0,0,0,0,0,0,0,0,0,0
1006583-eaten_alive,0,2,0,2,0,0,0,0,0,0,0,0,0
mon_oncle_damerique,8.1,9,9,0,100,0,2,2,0,100,3.9,640,84
monster_club,5.9,7,5,2,71,0,0,0,0,0,0,0,0
la-mort-en-direct-death-watch-death-in-full-view,0,0,0,0,0,0,0,0,0,0,0,0,0
motel_hell,5.7,16,11,5,68,0,1,1,0,100,3.1,1573,52
mothers_day,5.2,7,3,4,42,0,0,0,0,0,0,0,0
mountain_men,4.9,6,3,3,50,0,0,0,0,0,0,0,0
ninth_configuration,6.3,9,6,3,66,0,0,0,0,0,0,0,0
ffolkes,0,4,1,3,25,0,0,0,0,0,0,0,0
le-notti-del-terrore,0,2,1,1,50,0,0,0,0,0,0,0,0
nude_bomb,3.2,16,3,13,18,0,1,0,1,0,3,745,40
octagon,3.6,5,1,4,20,0,0,0,0,0,0,0,0
oh_god_book_2,5.1,6,3,3,50,0,1,0,1,0,2.8,490,44
oh_god_you_devil,5.1,7,2,5,28,0,0,0,0,0,0,0,0
oh_heavenly_dog,0,4,0,4,0,0,2,0,2,0,2.8,693,42
pepi-luci-bom-y-otras-chicas-del-monton-pepi-luci-bom-and-other-girls-like-mom,4.3,6,2,4,33,0,3,0,3,0,0,0,0
super_fuzz,3.5,6,0,6,0,0,1,0,1,0,3.2,682,52
ice_age,6.8,161,124,37,77,7.3,32,25,7,78,3.7,146598,81
resident_evil,4.5,120,41,79,34,3.8,23,4,19,17,3.4,69489,73
1113375-showtime,4.7,120,29,91,24,4,31,4,27,12,2.5,5638,30
harrisons_flowers,5.6,83,40,43,48,5.4,27,12,15,44,3.6,1213,75
kissing_jessica_stein,7,115,97,18,84,7.6,30,27,3,90,3.2,3869,61
pauline_and_paulette,6.9,53,44,9,83,7.5,15,14,1,93,3.8,211,80
eastern_promises,7.6,190,169,21,88,7.4,35,30,5,85,3.8,66267,82
y-tu-mama-tambien,8,126,115,11,91,8.8,29,28,1,96,3.9,22998,87
all_the_right_moves,4.9,19,10,9,52,0,3,2,1,66,2.9,2666,39
barabbas,6.8,6,6,0,100,0,0,0,0,0,0,0,0
i_think_i_do,0,4,1,3,25,0,1,0,1,0,3.5,349,64
paleface,6.9,7,7,0,100,0,0,0,0,0,0,0,0
road_to_morocco,7.8,12,11,1,91,0,0,0,0,0,0,0,0
road_to_singapore,6.4,9,9,0,100,0,0,0,0,0,0,0,0
road_to_utopia,7.5,6,6,0,100,0,0,0,0,0,0,0,0
1038419-split_second,0,2,0,2,0,0,0,0,0,0,0,0,0
tale_of_springtime,6.9,11,10,1,90,0,4,4,0,100,3.6,251,72
taps,6,14,11,3,78,0,1,1,0,100,3.4,2747,63
return-of-the-secaucus-seven,6.7,15,12,3,80,0,1,1,0,100,3.5,323,73
rude-boy2003,0,0,0,0,0,0,0,0,0,0,0,0,0
10004288-running_scared,4.5,128,51,77,39,4.4,31,10,21,32,3.6,35992,77
seems_like_old_times,6,11,8,3,72,0,1,0,1,0,3.3,1129,62
young_master,0,1,1,0,100,0,0,0,0,0,0,0,0
shogun_assassin,0,3,3,0,100,0,0,0,0,0,0,0,0
1157813-simon,5.6,5,3,2,60,0,4,2,2,50,4.1,338,87
smokey_and_the_bandit_ii,4,5,1,4,20,0,1,0,1,0,2.8,3299,55
smokey_and_the_bandit,6.2,22,17,5,77,0,1,0,1,0,3.4,8794,80
spetters,6.8,5,4,1,80,0,0,0,0,0,0,0,0
stir_crazy,6.2,14,10,4,71,0,1,0,1,0,3.4,3164,77
sallskapsresan-the-charter-trip,0,0,0,0,0,0,0,0,0,0,0,0,0
cousins,5.8,8,4,4,50,0,1,1,0,100,3.1,644,57
blade_2_bloodhunt,6,134,78,56,58,5.5,27,13,14,48,3.4,60022,72
sorority_boys,3.2,62,8,54,12,3.2,16,2,14,12,2.8,5444,57
1097991-george_washington,7.3,56,46,10,82,7.4,12,10,2,83,4,1443,86
homicide_the_movie,0,1,1,0,100,0,0,0,0,0,0,0,0
life_is_to_whistle,0,3,1,2,33,0,0,0,0,0,0,0,0
mr_sardonicus,4.6,8,3,5,37,0,0,0,0,0,0,0,0
straitjacket,6.4,5,4,1,80,0,0,0,0,0,0,0,0
clockstoppers,4.7,83,23,60,27,4.5,20,4,16,20,2.6,4856,35
death_to_smoochy,5.3,119,50,69,42,4,26,3,23,11,3,10569,61
panic_room,6.9,178,136,42,76,6.6,34,24,10,70,3,19615,61
1112954-rookie,7.2,140,115,25,82,7.4,32,29,3,90,3.3,10597,68
no_such_thing,5,42,12,30,28,4.9,15,4,11,26,3.3,777,60
piano_teacher,6.9,81,59,22,72,7.7,25,21,4,84,3.8,5369,81
time-out-l-emploi-du-temps,8,82,79,3,96,8.2,25,23,2,92,3.8,613,76
very_annie_mary,4.9,27,8,19,29,4.8,9,2,7,22,3.8,488,75
bar_girls,5,6,1,5,16,0,2,0,2,0,3,635,46
boxcar_bertha,4.9,20,9,11,45,0,4,2,2,50,2.9,1317,34
crimes_of_passion,4.9,9,3,6,33,0,1,0,1,0,3.2,217,54
evil_that_men_do,4.8,5,2,3,40,0,0,0,0,0,0,0,0
fraternity_vacation,0,3,0,3,0,0,2,0,2,0,3,279,47
impromptu,6.2,15,12,3,80,5.7,6,4,2,66,3.6,1242,73
salmonberries,6.2,7,5,2,71,0,0,0,0,0,0,0,0
wrong_guy,0,3,0,3,0,0,1,0,1,0,3.6,826,81
crimes,0,0,0,0,0,0,0,0,0,0,0,0,0
national_lampoons_van_wilder,3.5,86,16,70,18,3.1,21,2,19,9,3.3,23872,78
lucky_break,5.6,44,21,23,47,5.6,17,8,9,47,3.2,389,53
les-destinees,6,49,30,19,61,6.1,18,11,7,61,3.1,243,41
after_dark_my_sweet,6.7,15,13,2,86,6.9,5,4,1,80,3.3,506,57
atomic_cafe,7.4,14,14,0,100,0,0,0,0,0,0,0,0
1002820-body_and_soul,7.7,8,8,0,100,0,2,2,0,100,4,268,88
first_men_in_the_moon,6.1,6,4,2,66,0,0,0,0,0,0,0,0
kurosawa-a-documentary-on-the-acclaimed-director,0,0,0,0,0,0,0,0,0,0,0,0,0
slap_shot,6.8,24,20,4,83,0,3,1,2,33,0,0,0
changing_lanes,7,149,115,34,77,6.7,30,22,8,73,3,7920,49
frailty,6.9,133,98,35,73,6.6,31,22,9,70,3.5,8605,78
new_best_friend,2.9,38,2,36,5,2.6,10,1,9,10,3,636,42
sweetest_thing,4.2,104,26,78,25,4.2,26,7,19,26,3,21858,68
cats_meow,6.5,119,89,30,74,7.1,33,28,5,84,3.1,1938,48
1113402-human_nature,5.8,94,46,48,48,5.4,25,9,16,36,3.3,3892,62
my_big_fat_greek_wedding,6.7,121,91,30,75,6.3,25,18,7,72,3.2,49673,69
310_to_yuma,7.5,205,182,23,88,7.3,42,36,6,85,3.9,139372,85
bite_the_bullet,6.6,14,10,4,71,0,3,2,1,66,3.2,558,50
1003060-breakout,5.3,7,3,4,42,0,1,0,1,0,0,0,0
joe_versus_the_volcano,5.4,24,14,10,58,0,3,2,1,66,2.7,6794,45
open_city,8.8,22,22,0,100,0,4,4,0,100,4.2,1681,90
return_of_the_killer_tomatoes_the_sequel,2.8,5,0,5,0,0,0,0,0,0,0,0,0
return_to_horror_high,0,4,0,4,0,0,0,0,0,0,0,0,0
taking_care_of_business,2.6,5,0,5,0,0,1,0,1,0,2.8,695,48
three_men_and_a_baby,5.7,24,17,7,70,0,4,3,1,75,2.9,11309,51
three_men_and_a_little_lady,3.9,13,3,10,23,0,1,1,0,100,2.8,6348,48
transylvania_65000,4.2,10,2,8,20,0,0,0,0,0,0,0,0
watcher_in_the_woods,4.9,13,6,7,46,0,1,0,1,0,0,0,0
com_for_murder,0,0,0,0,0,0,0,0,0,0,0,0,0
scorpion_king,4.9,130,52,78,40,4.5,27,8,19,29,2.9,30398,53
behind_the_sun,6.7,46,34,12,73,6.7,18,13,5,72,3.9,968,86
chelsea_walls,4.1,46,12,34,26,4.5,15,5,10,33,3,515,43
1113649-enigma,6.6,104,75,29,72,6.8,29,22,7,75,3.2,2061,52
girls-cant-swim,5.9,34,24,10,70,6.5,14,11,3,78,2.9,255,37
joshua,6.3,97,61,36,62,6.9,31,24,7,77,2.9,13913,40
nine_queens,7.5,91,84,7,92,8,27,26,1,96,4.2,4937,93
triumph_of_love,5.5,70,33,37,47,5.7,27,13,14,48,3.1,452,49
world_traveler,4.9,66,23,43,34,4.8,23,8,15,34,2.8,516,26
jason_x,3.6,101,21,80,20,3.1,20,2,18,10,2.5,10745,38
life_or_something_like_it,4.5,117,32,85,27,4.4,30,7,23,23,2.8,6498,48
dogtown_and_zboys,7.5,93,85,8,91,7.5,29,27,2,93,3.9,3418,86
frank_mcklusky_ci,0,3,0,3,0,0,0,0,0,0,0,0,0
in_praise_of_love,5.7,72,37,35,51,6.1,26,15,11,57,3.4,600,59
singin_in_the_rain,9.2,44,44,0,100,8.8,9,9,0,100,3.9,28033,91
salton_sea,5.8,84,53,31,63,5.5,25,14,11,56,3.7,4972,81
vulgar,3.2,26,6,20,23,2.2,7,1,6,14,2.8,944,40
aviator,7.8,212,185,27,87,7.5,44,36,8,81,3.4,27084,73
bob_le_flambeur,8.1,29,28,1,96,7.2,6,5,1,83,4,1464,88
cadillac_man,5.3,10,5,5,50,0,2,1,1,50,2.7,1895,29
the-coca-cola-kid,5.1,16,7,9,43,0,4,1,3,25,2.9,374,35
i_am_cuba,8.6,31,31,0,100,8.9,7,7,0,100,4.2,1082,91
10007902-delirious,6.8,56,47,9,83,6.9,20,17,3,85,3.2,2792,52
full_moon_in_blue_water,4.2,6,1,5,16,0,1,0,1,0,2.9,281,30
1040798-husbands_and_wives,8.3,35,35,0,100,7.9,9,9,0,100,3.8,3905,83
gi_joe,4.6,153,52,101,33,3.8,25,6,19,24,3.3,302453,62
lenny,8.1,16,16,0,100,0,0,0,0,0,0,0,0
temp,4,19,6,13,31,0,4,0,4,0,2.6,338,16
thief_of_hearts,3.2,6,0,6,0,0,0,0,0,0,0,0,0
triumph_of_the_spirit,4.9,6,3,3,50,0,1,0,1,0,3.2,317,53
wild_orchid,3,13,1,12,7,0,1,0,1,0,0,0,0
deuces_wild,2.9,65,2,63,3,2.9,17,0,17,0,3,2133,52
hollywood_ending,5.4,130,60,70,46,5.3,35,13,22,37,3.2,3322,50
citizen-pinoy-the-basic-questions,0,0,0,0,0,0,0,0,0,0,0,0,0
mystic_masseur,5.8,64,33,31,51,6.1,23,14,9,60,3,60,36
warm_water_under_a_red_bridge,6.9,42,33,9,78,6.6,10,7,3,70,3.6,563,72
1002352-big_sleep,8.6,43,41,2,95,7.5,8,7,1,87,4.1,7772,91
butterflies_are_free,6.1,7,5,2,71,0,0,0,0,0,0,0,0
cactus_flower,7.1,10,10,0,100,0,1,1,0,100,3.6,1005,73
cassandra_crossing,4.9,7,2,5,28,0,0,0,0,0,0,0,0
giant_spider_invasion,0,1,0,1,0,0,0,0,0,0,0,0,0
iron_will,5.8,12,7,5,58,0,2,0,2,0,3.1,3444,61
mountains_of_the_moon,6.6,12,9,3,75,0,2,1,1,50,3.7,432,74
rambling_rose,7.2,17,17,0,100,7.4,5,5,0,100,3,541,40
soul_survivors,2.6,47,2,45,4,2.3,11,0,11,0,2.6,2441,34
1032182-white_fang,5.9,18,12,6,66,0,4,3,1,75,3.1,4170,62
white_fang_2_myth_of_the_white_wolf,6.4,6,4,2,66,0,2,2,0,100,3.2,1366,56
1112617-new_guy,3.1,91,6,85,6,3.5,22,3,19,13,3,9884,60
unfaithful,5.7,159,77,82,48,5.8,35,16,19,45,3.3,12656,70
lady_and_the_duke,6.6,70,50,20,71,7,25,21,4,84,3.4,337,55
10010418-whore,0,1,0,1,0,0,0,0,0,0,0,0,0
my_beautiful_laundrette,8.1,18,18,0,100,0,1,1,0,100,3.7,1973,75
ballad_of_a_soldier,8.5,12,12,0,100,0,1,1,0,100,4.2,814,91
big_bad_mama,5.5,11,7,4,63,0,0,0,0,0,0,0,0
big_bad_mama_ii,0,0,0,0,0,0,0,0,0,0,0,0,0
beyond_the_darkness,0,0,0,0,0,0,0,0,0,0,0,0,0
1003399-calamity_jane,5.7,9,6,3,66,0,0,0,0,0,0,0,0
the-cranes-are-flying,8.1,17,16,1,94,0,2,1,1,50,4.2,1056,93
the-devildoll-the-witch-of-timbuctoo,0,0,0,0,0,0,0,0,0,0,0,0,0
harvey_girls,7.5,6,6,0,100,0,0,0,0,0,0,0,0
lady_in_red,0,2,1,1,50,0,0,0,0,0,0,0,0
about_a_boy,7.7,159,148,11,93,7.5,35,32,3,91,2.8,137687,51
star_wars_episode_ii_attack_of_the_clones,6.5,215,142,73,66,5.5,40,16,24,40,3.3,108730,69
1183429-believers,0,3,0,3,0,0,0,0,0,0,0,0,0
balaclava-1854,0,0,0,0,0,0,0,0,0,0,0,0,0
every_which_way_but_loose,4.5,13,4,9,30,0,0,0,0,0,0,0,0
1010004-hound_of_the_baskervilles,7.8,11,11,0,100,0,0,0,0,0,0,0,0
i_want_to_live,7.9,11,11,0,100,0,0,0,0,0,0,0,0
last_waltz,8.4,39,38,1,97,8.1,12,11,1,91,4.3,3891,92
pride_and_the_passion,4.8,7,1,6,14,0,1,1,0,100,3,672,35
1114051-enough,4,121,26,95,21,3.9,30,5,25,16,3.1,15185,71
1114154-insomnia,7.7,166,153,13,92,7.8,33,31,2,93,3.2,18085,66
spirit_stallion_of_the_cimarron,6.4,125,86,39,68,6.9,29,23,6,79,3.3,8302,72
cq,6.2,73,48,25,65,5.8,22,14,8,63,3.4,1171,66
thirteen_conversations_about_one_thing,7.4,108,89,19,82,6.9,25,19,6,76,3.4,2120,65
1003296-bus_stop,7.6,10,9,1,90,0,0,0,0,0,0,0,0
midnight_cowboy,8.3,49,44,5,89,6.8,6,5,1,83,3.9,8994,87
dont_bother_to_knock,6.8,7,7,0,100,0,0,0,0,0,0,0,0
dr_mabuse_the_gambler,7.4,11,10,1,90,0,1,0,1,0,4.1,721,90
lets_make_love,5.5,11,7,4,63,0,0,0,0,0,0,0,0
1014137-monkey_business,7.8,12,11,1,91,0,0,0,0,0,0,0,0
1080265-requiem_for_a_heavyweight,7.6,8,7,1,87,0,0,0,0,0,0,0,0
river_of_no_return,5.8,13,8,5,61,0,3,3,0,100,3.4,1421,59
sum_of_all_fears,6,166,98,68,59,5.6,35,16,19,45,3,11603,53
undercover_brother,6.6,126,96,30,76,6.1,24,17,7,70,2.8,7732,60
nijinsky_2002,0,0,0,0,0,0,0,0,0,0,0,0,0
sleepy_time_gal,6.9,19,15,4,78,7.5,7,6,1,85,3.3,174,45
84_charing_cross_road,7.4,15,12,3,80,0,2,0,2,0,3.7,1344,76
1005131-dakota,0,2,0,2,0,0,0,0,0,0,0,0,0
desert_rats,6.3,5,4,1,80,0,0,0,0,0,0,0,0
la_buche,6.4,20,14,6,70,6.6,7,5,2,71,3.4,364,60
1020312-stray_dog,7.4,15,14,1,93,0,0,0,0,0,0,0,0
1040198-rapid_fire,4.7,14,4,10,28,0,4,0,4,0,3.1,3041,51
silent_running,6.6,25,17,8,68,0,4,3,1,75,3.5,2762,69
1113757-summer_holiday,0,1,0,1,0,0,0,0,0,0,0,0,0
villain,3.7,7,0,7,0,0,0,0,0,0,0,0,0
zombie_holocaust,0,2,0,2,0,0,0,0,0,0,0,0,0
1114548-bad_company,3.9,134,14,120,10,4,31,5,26,16,2.8,6415,42
divine_secrets_of_the_yaya_sisterhood,5.3,142,62,80,43,5.3,34,17,17,50,3.2,12363,63
cherish,5.7,76,36,40,47,5.8,23,11,12,47,3.4,572,60
fast_runner,8,94,85,9,90,8.5,26,25,1,96,3.8,1275,80
bourne_identity,7,180,148,32,82,6.9,37,30,7,81,3.9,125823,91
1112357-scoobydoo,4.4,138,39,99,28,4.8,29,12,17,41,2.7,20362,49
windtalkers,5.1,164,53,111,32,5.3,37,13,24,35,3.2,15905,57
country-boys,0,0,0,0,0,0,0,0,0,0,0,0,0
emperors_new_clothes,6.6,84,62,22,73,6.6,26,19,7,73,3.4,293,61
gangster-no-1,6.4,51,37,14,72,6.3,12,8,4,66,3.7,2271,76
harvard_man,4.6,36,12,24,33,5.3,14,6,8,42,2.7,1487,34
dark_blue_world,6.2,58,36,22,62,6.5,20,13,7,65,3.8,719,82
1114548-bad_company,3.9,134,14,120,10,4,31,5,26,16,2.8,6415,42
caveman,4.1,15,3,12,20,0,2,1,1,50,3,1935,52
1007472-five_card_stud,0,1,1,0,100,0,1,1,0,100,3.3,527,55
goin_south,6.6,10,9,1,90,0,0,0,0,0,0,0,0
hero_and_the_terror,3.6,5,0,5,0,0,1,0,1,0,2.9,782,45
1019007-silver_bullet,5.2,14,7,7,50,0,1,1,0,100,3.2,3559,59
1032814-sorry_wrong_number,6.8,21,18,3,85,0,3,1,2,33,3.6,1027,78
horses_mouth,7.5,14,13,1,92,0,0,0,0,0,0,0,0
1013238-manhattan_project,5.5,17,8,9,47,0,1,1,0,100,3,744,47
1029024-men_at_work,4.2,22,7,15,31,0,4,2,2,50,2.7,3778,43
sob,7.1,14,14,0,100,0,0,0,0,0,0,0,0
she_wore_a_yellow_ribbon,8.3,14,14,0,100,0,0,0,0,0,0,0,0
traces_of_red,3.5,6,1,5,16,0,2,1,1,50,3,197,35
vi_warshawski,3.6,20,4,16,20,0,2,1,1,50,2.4,698,25
juwanna_mann,3.2,82,7,75,8,3.2,24,2,22,8,2.5,1219,46
lilo_and_stitch,7.3,144,123,21,85,7.2,29,22,7,75,3.2,36598,65
minority_report,8,222,203,19,91,7.9,38,34,4,89,3.4,69660,74
rabbitproof_fence,7.6,133,116,17,87,7.6,29,25,4,86,3.8,5026,85
sunshine_state,7,106,85,21,80,7,29,23,6,79,3.1,607,50
hey_arnold_the_movie,4.6,76,23,53,30,4.7,19,6,13,31,2.8,2763,37
mr_deeds,4,153,33,120,21,3.6,30,5,25,16,3.3,69840,68
lovely_and_amazing,7.3,119,102,17,85,7.3,28,25,3,89,3.4,1223,62
look_whos_talking_now,2.5,23,0,23,0,3.2,6,0,6,0,2.5,9093,41
lost_in_yonkers,5.8,16,11,5,68,0,3,1,2,33,3.4,491,70
mo_money,4,22,3,19,13,0,4,1,3,25,2.9,1450,51
object_of_beauty,6.1,12,9,3,75,0,2,2,0,100,2.9,442,29
wagons_east,1.8,10,0,10,0,0,2,0,2,0,2.5,1055,33
zebrahead,6.1,14,10,4,71,0,4,3,1,75,3.3,221,62
like_mike,5.5,96,54,42,56,5.7,28,13,15,46,2.8,7917,55
men_in_black_ii,5.2,187,72,115,38,5.5,34,14,20,41,3.1,54446,57
powerpuff_girls_movie,6.1,99,63,36,63,6.2,24,17,7,70,3.1,2190,53
me_without_you,6.2,65,43,22,66,6.3,22,16,6,72,3.8,1522,78
crocodile_hunter_collision_course,5.2,81,42,39,51,5.7,20,12,8,60,2.8,4549,51
reign_of_fire,5.2,149,59,90,39,4.7,31,13,18,41,3,15531,55
road_to_perdition,7.5,205,169,36,82,7.1,37,29,8,78,3.5,23335,81
all_about_lily_chouchou,6.7,37,25,12,67,7.3,11,8,3,72,4.1,2372,88
my_wife_is_an_actress,6.2,72,47,25,65,6.7,23,17,6,73,3.4,747,66
never_say_never_again,5.9,34,22,12,64,6.2,5,3,2,60,3.1,7414,48
20_million_miles_to_earth,6.4,8,7,1,87,0,0,0,0,0,0,0,0
grand_theft_auto,4.8,11,3,8,27,0,0,0,0,0,0,0,0
a_perfect_getaway,5.8,124,76,48,61,5.9,29,18,11,62,3.2,102622,50
1776,6.8,14,8,6,57,0,1,0,1,0,3.8,2415,80
fox_and_his_friends,7.8,15,13,2,86,0,3,2,1,66,0,0,0
legend-of-boggy-creek,0,0,0,0,0,0,0,0,0,0,0,0,0
halloween_resurrection,3.4,57,6,51,10,3.4,16,2,14,12,2.8,14228,46
sex_and_lucia,6.5,69,49,20,71,5.8,20,12,8,60,3.9,6145,85
eight_legged_freaks,5.5,140,66,74,47,5,25,9,16,36,2.5,10925,36
k19_the_widowmaker,6.1,165,100,65,60,6.3,33,21,12,63,3,6024,50
stuart_little_2,6.9,114,95,19,83,6.9,29,26,3,89,2.7,10893,44
austin_powers_in_goldmember,5.8,179,97,82,54,5.8,37,22,15,59,3,145625,47
country_bears,4.3,77,21,56,27,4.2,21,4,17,19,2.7,2600,39
the-kid-makes-the-picture,0,0,0,0,0,0,0,0,0,0,0,0,0
happy_times,6.4,60,43,17,71,6.7,20,16,4,80,3.7,927,76
tadpole,6.7,104,81,23,77,6.7,31,24,7,77,3.2,888,56
who_is_cletis_tout,4.3,55,13,42,23,4.4,20,6,14,30,3.1,596,48
harry_and_walter_go_to_new_york,5.9,7,4,3,57,0,1,0,1,0,3.3,105,44
merchant_of_four_seasons,7.9,12,11,1,91,0,2,1,1,50,0,0,0
nosferatu_the_vampyre,7.6,34,32,2,94,0,4,4,0,100,3.7,5091,81
big_bus,5.9,5,3,2,60,0,0,0,0,0,0,0,0
eddy_duchin_story,0,2,0,2,0,0,0,0,0,0,0,0,0
fathom,5,5,2,3,40,0,0,0,0,0,0,0,0
in_like_flint,6.2,15,11,4,73,0,1,0,1,0,3.3,618,53
la_terra_trema,8.5,6,6,0,100,0,0,0,0,0,0,0,0
modesty_blaise,0,4,1,3,25,0,0,0,0,0,0,0,0
ossessione,8.2,9,9,0,100,0,2,2,0,100,3.9,583,83
our_man_flint,6.6,18,15,3,83,0,0,0,0,0,0,0,0
red_beard,7.8,11,9,2,81,0,2,2,0,100,4.3,2413,94
1000355-adventures_of_robin_hood,8.9,43,43,0,100,8.6,7,7,0,100,3.7,6404,84
1021699-top_secret,6.4,25,19,6,76,0,1,1,0,100,3.4,8375,77
master_of_disguise,2.2,97,2,95,2,2.2,26,0,26,0,2.3,6303,39
signs,6.8,223,164,59,73,5.9,39,22,17,56,3.2,63081,65
1114866-last_kiss,6.4,78,57,21,73,6.4,25,17,8,68,3.8,2248,77
spy_kids_2_island_of_lost_dreams,6.6,127,95,32,74,6.7,30,23,7,76,2.6,12329,43
a-good-death-beats-a-dull-life,0,0,0,0,0,0,0,0,0,0,0,0,0
blood_work,5.6,147,79,68,53,6.3,34,24,10,70,3,4504,42
xxx,5.6,174,83,91,47,5,32,11,21,34,3.2,47523,69
manchester-fiesta-part-1,0,0,0,0,0,0,0,0,0,0,0,0,0
biggie_and_tupac,6.7,47,38,9,80,5.9,15,10,5,66,3.8,1434,79
chateau,5.3,52,26,26,50,5,15,6,9,40,2.7,261,28
pandoras_box,8.5,23,21,2,91,8.1,8,6,2,75,4.1,1316,88
secret_ballot,7,57,47,10,82,6.8,16,13,3,81,3.4,349,62
martin_lawrence_live_runteldat,5,56,21,35,37,5.6,22,11,11,50,3.8,23,71
lan_yu,6.2,34,22,12,64,6.1,13,8,5,61,3.9,584,83
songs-from-the-second-floor,7.4,33,29,4,87,8,11,11,0,100,4.2,2079,90
read_my_lips,7.8,95,92,3,96,8.1,26,25,1,96,3.8,1495,81
merci-pour-le-chocolat,7.2,50,42,8,84,7.8,15,15,0,100,3.5,668,64
beau_pere,6.6,5,4,1,80,0,1,1,0,100,3.5,254,73
change_of_habit,4,10,1,9,10,0,0,0,0,0,0,0,0
a-matter-of-taste,0,0,0,0,0,0,0,0,0,0,0,0,0
lean_on_me,5.8,14,9,5,64,0,1,0,1,0,3.7,5235,86
1017814-rollerball,6,25,17,8,68,0,4,1,3,25,3.2,2655,61
adventures_of_pluto_nash,2.7,72,4,68,5,2.2,13,0,13,0,2,3816,20
1113404-crush,5,78,27,51,34,5,24,8,16,33,3.2,804,58
mostly_martha,7.2,82,75,7,91,7,25,22,3,88,4,2477,88
seom-the-isle,6.2,32,24,8,75,7,8,7,1,87,3.7,1897,73
10009228-possession,0,2,0,2,0,0,1,0,1,0,2.9,4231,34
family-flaw,0,0,0,0,0,0,0,0,0,0,0,0,0
serving_sara,3,105,5,100,4,3.1,24,2,22,8,2.4,2909,31
undisputed,5.5,103,50,53,48,6.1,29,19,10,65,3.2,2298,56
amys_o,4.4,30,8,22,26,5.4,8,4,4,50,2.8,555,33
children_on_their_birthdays,0,3,0,3,0,0,1,0,1,0,3.3,281,57
1082899-hush,3.4,37,4,33,10,3.2,8,0,8,0,2.9,1448,43
how-i-killed-my-father,0,0,0,0,0,0,0,0,0,0,0,0,0
satin_rouge,6.9,47,39,8,82,7.1,19,17,2,89,3.5,291,64
stellaluna_2004,0,0,0,0,0,0,0,0,0,0,0,0,0
care_bears_movie_2_a_new_generation,0,0,0,0,0,0,0,0,0,0,0,0,0
clash_of_the_titans,5.8,37,24,13,64,0,2,1,1,50,3.4,10585,70
1036179-hot_shots,6.5,22,18,4,81,0,1,1,0,100,3,14175,63
nightmare-city-2035,0,0,0,0,0,0,0,0,0,0,0,0,0
shark_swarm,0,1,0,1,0,0,0,0,0,0,0,0,0
time_after_time,7.2,28,24,4,85,0,4,3,1,75,3.5,1546,68
unearthly,0,2,1,1,50,0,0,0,0,0,0,0,0
976evil-ii,0,0,0,0,0,0,0,0,0,0,0,0,0
camilla,5.2,5,2,3,40,0,2,0,2,0,3,598,31
down_and_out_in_beverly_hills,6.8,24,20,4,83,0,4,3,1,75,2.9,2039,49
flaming_star,7.3,10,9,1,90,0,0,0,0,0,0,0,0
love_me_tender,5.4,8,3,5,37,0,0,0,0,0,0,0,0
return_of_the_vampire,5.3,5,3,2,60,0,0,0,0,0,0,0,0
revenge_of_frankenstein,6.2,7,6,1,85,0,0,0,0,0,0,0,0
1019779-stakeout,6.5,18,15,3,83,0,1,1,0,100,2.9,2040,50
wild_in_the_country,5.8,8,4,4,50,0,0,0,0,0,0,0,0
wolfen,5.8,22,16,6,72,0,1,1,0,100,3,988,45
fear_dot_com,2.6,87,3,84,3,3,15,0,15,0,2.3,7455,28
slap-her-shes-french,4.7,25,9,16,36,0,2,0,2,0,2.9,1785,45
love_and_a_bullet,0,2,0,2,0,0,0,0,0,0,0,0,0
1118498-mad_love,5.3,49,23,26,46,5.6,14,6,8,42,3.6,465,67
a_nous_la_liberte,8.3,16,16,0,100,0,2,2,0,100,3.7,914,76
1033465-true_colors,5,14,7,7,50,0,4,0,4,0,3,876,47
1083484-blade,5.7,83,46,37,55,4.6,24,7,17,29,3.6,87683,78
city_by_the_sea,5.8,140,67,73,47,5.8,33,17,16,51,2.9,3070,41
swimfan,3.9,89,13,76,14,4.3,16,4,12,25,2.5,5068,38
incubus,0,3,0,3,0,0,0,0,0,0,0,0,0
johnny_dangerously,5,15,7,8,46,0,1,0,1,0,3.2,1967,60
1205377-last_house_on_the_left,4.9,143,60,83,41,4.5,29,12,17,41,2.7,137767,55
thesis,6.8,7,5,2,71,0,0,0,0,0,0,0,0
barbershop_2_back_in_business,6.3,123,84,39,68,6.4,34,23,11,67,3.1,7601,58
stealing_harvard,3.2,102,8,94,7,3.2,25,1,24,4,2.7,2451,42
transporter,5.6,122,65,57,53,5.1,28,13,15,46,3.5,52782,78
alias_betty,7.2,51,47,4,92,7.3,19,18,1,94,3.4,366,57
children-of-the-century,5.2,42,18,24,42,5.4,12,5,7,41,3.6,422,71
igby_goes_down,6.9,126,96,30,76,6.9,32,24,8,75,3.4,8640,77
aspen_extreme,3.8,9,2,7,22,0,1,0,1,0,2.9,1218,51
betsys_wedding,5.3,7,3,4,42,0,2,1,1,50,2.8,904,41
captain_ron,4.2,13,3,10,23,0,2,0,2,0,2.7,4124,44
devil-bat,5.6,9,5,4,55,0,0,0,0,0,0,0,0
ernest_goes_to_jail,3.8,8,1,7,12,0,0,0,0,0,0,0,0
ernest-scared-stupid,3.2,5,1,4,20,0,0,0,0,0,0,0,0
gypsy_moths,0,0,0,0,0,0,0,0,0,0,0,0,0
hills_have_eyes_2,3.2,64,7,57,10,3.6,16,2,14,12,2.9,63799,50
hills_have_eyes,5.3,133,65,68,48,5,30,12,18,40,3.1,75042,64
alive_and_kicking,6.7,6,5,1,83,0,2,2,0,100,3.2,492,45
mack,0,3,2,1,66,0,0,0,0,0,0,0,0
monkey_trouble,5.6,11,6,5,54,0,2,2,0,100,2.5,2170,39
monster_in_the_closet,0,1,0,1,0,0,0,0,0,0,0,0,0
no_way_to_treat_a_lady,7.8,9,8,1,88,0,0,0,0,0,0,0,0
1018865-shock_waves,0,2,2,0,100,0,0,0,0,0,0,0,0
spaced_invaders,3.3,11,1,10,9,0,2,0,2,0,2.7,834,43
suburban_commando,3.7,10,2,8,20,0,1,0,1,0,2.3,2563,31
surf_ninjas,3.3,12,1,11,8,0,4,1,3,25,3.1,2874,64
tabu,8.2,8,8,0,100,0,2,2,0,100,3.8,448,76
the-wanderers,6.8,17,15,2,88,0,0,0,0,0,0,0,0
1024237-yearling,8.4,11,11,0,100,0,0,0,0,0,0,0,0
ladykillers,6.1,185,101,84,54,5.8,39,18,21,46,2.8,12107,40
lavender_hill_mob,8.2,18,18,0,100,0,0,0,0,0,0,0,0
man_in_the_white_suit,8.4,8,8,0,100,0,0,0,0,0,0,0,0
society,5.2,7,3,4,42,0,0,0,0,0,0,0,0
son_of_the_bride,7.3,57,49,8,85,6.8,18,13,5,72,4.2,1942,91
1116582-experiment,6.6,64,46,18,71,5.9,19,10,9,52,3.9,5538,88
ballistic_ecks_vs_sever,2.6,108,0,108,0,2.4,28,0,28,0,2.2,3969,25
banger_sisters,5.3,140,66,74,47,5.1,34,14,20,41,2.7,4139,45
four_feathers,5.4,149,61,88,40,5.6,32,13,19,40,3.2,6862,65
1116086-trapped,4.1,56,10,46,17,4,12,2,10,16,3.1,4086,56
8_women,6.9,111,87,24,78,6.8,30,24,6,80,3.6,5397,74
his_secret_life,6.5,34,25,9,73,6.9,13,11,2,84,4.1,1356,89
invincible,6.4,132,94,38,71,6.2,32,19,13,59,3.6,34698,75
mesmerist,0,2,0,2,0,0,0,0,0,0,0,0,0
secretary,6.7,140,104,36,74,6.5,30,22,8,73,3.7,16511,84
spirited_away,8.5,154,150,4,97,8.7,31,31,0,100,4.1,72315,95
trials_of_henry_kissinger,7.2,57,54,3,94,7.8,17,17,0,100,3.6,328,74
sweet_home_alabama,5.2,154,57,97,37,5.1,33,13,20,39,3.3,82825,77
tuxedo,4.4,136,30,106,22,4.1,28,3,25,10,2.6,12285,43
fly-thought-on-golden-wings,0,0,0,0,0,0,0,0,0,0,0,0,0
crazy_as_hell,5.3,14,7,7,50,4.6,5,2,3,40,3.2,275,55
1140811-fond_kiss,7.4,24,21,3,87,0,4,4,0,100,3.7,1269,73
moonlight_mile,6.4,145,90,55,62,6.2,33,18,15,54,3.4,3000,64
shanghai_ghetto,6.8,44,36,8,81,6.7,21,18,3,85,3.6,181,67
skins,5.9,58,34,24,58,5.6,19,10,9,52,4.1,578,86
wasabi,5.1,42,18,24,42,5.5,13,7,6,53,3.5,3717,69
jonah_a_veggietales_movie,5.8,54,35,19,64,6.1,18,14,4,77,3.4,4629,70
red_dragon,6.4,183,125,58,68,5.9,35,19,16,54,3.4,39977,74
between_strangers,4.3,8,2,6,25,0,2,0,2,0,3.3,164,52
bloody_sunday,7.9,102,94,8,92,8.2,30,28,2,93,4,2812,89
heaven,6.7,86,63,23,73,6.4,25,17,8,68,3.7,3048,77
pipe_dream,6.4,18,13,5,72,6.6,7,5,2,71,2.8,194,26
man_from_elysian_fields,5.9,70,36,34,51,5.6,25,11,14,44,3.3,426,54
welcome_to_collinwood,5.9,64,34,30,53,6,22,11,11,50,3.2,1767,54
flirting_with_disaster,7.4,42,36,6,85,8.5,6,6,0,100,3.3,2127,65
godzilla-vs-mothra,6.7,9,8,1,88,0,0,0,0,0,0,0,0
godzillas-revenge,4.8,6,2,4,33,0,1,0,1,0,2.7,774,30
godzilla_king_of_the_monsters,6.9,20,16,4,80,0,3,2,1,66,3.6,2215,73
modern_times,8.9,47,47,0,100,8.2,11,11,0,100,4.2,9563,95
onion_field,8.2,5,5,0,100,0,0,0,0,0,0,0,0
powaqqatsi,6.8,8,5,3,62,0,1,0,1,0,3.9,1251,83
pride_of_the_yankees,7.4,20,18,2,90,0,3,3,0,100,3.9,1471,88
texasville,5.6,21,12,9,57,4.5,5,2,3,40,2.9,302,45
1005199-dangerous_liaisons,7.7,27,25,2,92,6.5,6,5,1,83,3.7,11359,84
ernest-goes-to-africa,0,0,0,0,0,0,0,0,0,0,0,0,0
ernest-in-the-army,3,6,1,5,16,0,0,0,0,0,0,0,0
horror_of_dracula,7.5,27,24,3,88,0,3,2,1,66,3.6,3118,73
strange_brew,6.5,20,14,6,70,0,1,0,1,0,3.4,4156,80
incredible_mr_limpet,5.3,7,3,4,42,0,0,0,0,0,0,0,0
1072972-fan,4.8,25,10,15,40,5.3,5,2,3,40,2.8,5593,37
festival_in_cannes,6.1,54,35,19,64,6,20,12,8,60,2.8,203,32
1007522-flashback,4.9,13,5,8,38,0,1,1,0,100,3,804,54
hanky_panky,4.8,8,3,5,37,0,0,0,0,0,0,0,0
rocking_horse_winner,7.7,6,5,1,83,0,0,0,0,0,0,0,0
seance_on_a_wet_afternoon,7.2,9,7,2,77,0,0,0,0,0,0,0,0
shamus,5,7,3,4,42,0,1,0,1,0,3,301,34
wrong_guy,0,3,0,3,0,0,1,0,1,0,3.6,826,81
eight_below,6.5,139,99,40,71,6.1,31,16,15,51,3.4,27593,80
brown_sugar,6.2,84,54,30,64,6.5,28,20,8,71,3.8,11172,88
knockaround_guys,4.3,97,19,78,19,4.2,25,4,21,16,3.1,4913,58
rules_of_attraction,5.3,134,59,75,44,4.9,27,9,18,33,3.2,10253,71
tuck_everlasting,6.3,114,69,45,60,6.2,28,16,12,57,3.3,22077,66
white_oleander,6.5,131,91,40,69,6,31,18,13,58,3.5,9063,79
bowling_for_columbine,8.2,160,154,6,96,7.7,30,28,2,93,3.5,24080,81
comedian,6.8,88,67,21,76,6.9,27,22,5,81,3.4,1389,66
on_guard,7,30,26,4,86,7,14,12,2,85,3.7,406,70
pokemon_4ever,3.5,36,5,31,13,3.1,16,1,15,6,3.2,4367,58
punchdrunk_love,7.4,179,141,38,78,7.4,36,29,7,80,3.2,24379,72
1116774-swept_away,2.8,77,4,73,5,3,28,4,24,14,2.2,2205,28
the-young-unknowns,4,28,3,25,10,4,12,2,10,16,2.6,115,33
abandon,4.3,109,18,91,16,4.1,26,6,20,23,2.7,2670,37
formula_51,4.3,101,26,75,25,3.9,27,5,22,18,3.1,5566,61
ring,6.6,169,120,49,71,6.3,32,18,14,56,3,146246,50
auto_focus,6.7,155,112,43,72,6.9,37,28,9,75,3.2,1283,56
blame_it_on_fidel,7.4,43,40,3,93,7.8,12,11,1,91,4.1,2344,90
grey_zone,7,80,55,25,68,6.7,26,17,9,65,3.5,1987,71
1117372-hansel_and_gretel,3.2,5,0,5,0,0,3,0,3,0,3.1,1129,50
naqoyqatsi,5.8,52,25,27,48,5.8,16,9,7,56,3.7,1161,74
real_women_have_curves,6.8,82,68,14,82,7.2,23,21,2,91,3.6,2864,73
russian_ark,7.8,93,82,11,88,8.3,24,22,2,91,3.9,2668,80
take_care_of_my_cat,6.8,27,22,5,81,6.5,8,5,3,62,3.7,622,80
tully,6.9,52,42,10,80,6.8,20,16,4,80,3.6,374,78
billy_bathgate,5.2,18,9,9,50,0,2,0,2,0,2.8,1397,32
grave_of_the_fireflies,8.9,22,20,2,90,0,2,2,0,100,4.3,17989,93
jason_goes_to_hell_the_final_friday,4.1,15,4,11,26,0,2,0,2,0,2.8,9066,47
1013632-mechanic,0,3,1,2,33,0,1,0,1,0,3.5,913,70
saturday_night_fever,7.4,38,34,4,89,0,4,3,1,75,3.1,13427,67
10006370-stay_alive,3,57,5,52,8,2.8,14,1,13,7,3.3,40388,60
to_the_devil_a_daughter,4,6,1,5,16,0,1,0,1,0,3.1,703,44
urban_cowboy,6.5,13,10,3,76,0,0,0,0,0,0,0,0
terror_train,4.6,9,3,6,33,0,1,0,1,0,2.9,1162,40
times_square,0,4,1,3,25,0,1,0,1,0,3.6,569,66
tom_horn,0,4,4,0,100,0,0,0,0,0,0,0,0
up_the_academy,0,4,0,4,0,0,1,0,1,0,3.2,244,51
when_time_ran_out,0,4,0,4,0,0,0,0,0,0,0,0,0
wholly_moses,0,0,0,0,0,0,0,0,0,0,0,0,0
xanadu,4.5,22,9,13,40,0,2,1,1,50,3,3569,60
all_the_marbles,0,0,0,0,0,0,0,0,0,0,0,0,0
absence_of_malice,6.6,22,19,3,86,6.6,5,4,1,80,3.3,1000,55
all-night-long-1962,0,0,0,0,0,0,0,0,0,0,0,0,0
the-amateurs,3.9,24,4,20,16,0,4,1,3,25,3,8866,46
banana-joe,0,0,0,0,0,0,0,0,0,0,0,0,0
marianne_and_juliane,0,1,1,0,100,0,0,0,0,0,0,0,0
blow_out,7.5,36,32,4,88,7.1,5,4,1,80,3.6,2727,74
1078022-buddy,5.4,19,5,14,26,6.2,6,2,4,33,2.8,1106,37
burn_after_reading,6.8,217,169,48,77,6.2,42,26,16,61,3.4,71248,64
butterfly_effect,4.8,166,55,111,33,3.8,34,6,28,17,3.6,109956,81
cannibal_ferox,0,3,0,3,0,0,0,0,0,0,0,0,0
1003547-carbon_copy,0,1,0,1,0,0,0,0,0,0,0,0,0
charlie_chan_and_the_curse_of_the_dragon_queen,5.5,5,2,3,40,0,0,0,0,0,0,0,0
1004110-chosen,5.6,9,7,2,77,0,2,2,0,100,3.8,256,78
the-goat-1921,0,0,0,0,0,0,0,0,0,0,0,0,0
continental_divide,6.2,9,7,2,77,0,2,1,1,50,3,537,48
the-creature-wasnt-nice,0,0,0,0,0,0,0,0,0,0,0,0,0
man_of_iron,0,1,1,0,100,0,0,0,0,0,0,0,0
dead_and_buried,6.2,11,8,3,72,0,0,0,0,0,0,0,0
deadly_blessing,4.4,5,1,4,20,0,0,0,0,0,0,0,0
death_hunt,0,3,1,2,33,0,1,0,1,0,3.5,872,71
endless_love,3.9,13,3,10,23,0,3,0,3,0,0,0,0
enter_the_ninja,0,1,0,1,0,0,0,0,0,0,0,0,0
entity,0,2,2,0,100,0,0,0,0,0,0,0,0
eye_of_the_needle,6.5,13,11,2,84,0,1,1,0,100,3.4,963,61
1020414-eyewitness,0,0,0,0,0,0,0,0,0,0,0,0,0
faces-of-death-ii,0,0,0,0,0,0,0,0,0,0,0,0,0
faces_of_death_pt_3,0,0,0,0,0,0,0,0,0,0,0,0,0
faces-of-death-iv,0,0,0,0,0,0,0,0,0,0,0,0,0
faces-of-death-v,0,0,0,0,0,0,0,0,0,0,0,0,0
faces-of-death-vi,0,0,0,0,0,0,0,0,0,0,0,0,0
faces-of-death,2.6,11,2,9,18,0,0,0,0,0,0,0,0
woman_next_door,7.7,10,9,1,90,0,3,3,0,100,3.8,931,80
first_monday_in_october,0,4,1,3,25,0,0,0,0,0,0,0,0
fort_apache_the_bronx,6.6,11,9,2,81,0,1,0,1,0,3.2,1172,57
four_friends,6.9,7,5,2,71,0,1,1,0,100,3.6,291,69
merchant_of_four_seasons,7.9,12,11,1,91,0,2,1,1,50,0,0,0
1008055-galaxy_of_terror,5.1,10,4,6,40,0,0,0,0,0,0,0,0
1008074-gallipoli,7.4,21,18,3,85,0,2,1,1,50,3.6,5646,77
chinese_ghost_story,7.8,8,6,2,75,0,0,0,0,0,0,0,0
going_ape,0,0,0,0,0,0,0,0,0,0,0,0,0
gregorys_girl,7.7,13,12,1,92,0,4,4,0,100,3.7,1117,79
gota-kanal-eller-vem-drog-ur-proppen-who-pulled-the-plug,0,0,0,0,0,0,0,0,0,0,0,0,0
cool_hand_luke,8.8,44,44,0,100,8.5,6,6,0,100,4.1,17521,93
happy_birthday_to_me,5.2,8,2,6,25,0,0,0,0,0,0,0,0
heartbeeps,1.6,5,0,5,0,0,0,0,0,0,0,0,0
ladies-and-gentlemen-the-fabulous-stains,0,0,0,0,0,0,0,0,0,0,0,0,0
1149046-lady_chatterleys_lover,0,0,0,0,0,0,0,0,0,0,0,0,0
1012184-legend_of_the_lone_ranger,0,0,0,0,0,0,0,0,0,0,0,0,0
lili_marleen,5.8,5,2,3,40,0,3,1,2,33,3.8,317,79
10002128-lola,8.1,6,6,0,100,0,1,1,0,100,3.9,529,82
looker,4.4,17,5,12,29,0,2,0,2,0,3.2,1109,50
looney_looney_looney_bugs_bunny_movie,0,3,2,1,66,0,0,0,0,0,0,0,0
i_madman,0,4,3,1,75,0,1,1,0,100,3,387,44
mis-teddy-bear,0,0,0,0,0,0,0,0,0,0,0,0,0
modern_problems,0,3,0,3,0,0,0,0,0,0,0,0,0
modern_romance,6.4,20,17,3,85,0,1,1,0,100,3.6,466,72
ms_45,6.9,9,7,2,77,0,0,0,0,0,0,0,0
my_bloody_valentine_3_d,5.7,85,48,37,56,5.2,8,3,5,37,3.1,111307,49
my_dinner_with_andre,7.1,18,16,2,88,0,1,1,0,100,4,1441,85
your_friends_and_neighbors,7,55,42,13,76,6.4,20,13,7,65,3.3,1418,60
night-of-the-zombies-battalion-of-the-living-deadgamma-693the-chillingsister-of-death,0,0,0,0,0,0,0,0,0,0,0,0,0
night_the_lights_went_out_in_georgia,0,1,1,0,100,0,0,0,0,0,0,0,0
1015639-only_when_i_laugh,4.9,6,3,3,50,0,1,0,1,0,3.1,189,39
1016119-pennies_from_heaven,7,24,20,4,83,4.3,5,1,4,20,3.3,851,58
five_easy_pieces,8.2,30,25,5,83,6.5,5,3,2,60,3.9,4148,85
piranha_2_the_spawning,3.4,13,1,12,7,0,1,0,1,0,2,692,11
polyester,7.1,17,15,2,88,0,0,0,0,0,0,0,0
1016793-private_lessons,2.7,6,0,6,0,0,1,0,1,0,2.9,1236,38
le-professionnel,0,1,0,1,0,0,0,0,0,0,0,0,0
derrida,6.7,34,28,6,82,7.2,11,10,1,90,3.3,333,59
ghost_ship,3.8,119,15,104,12,3.5,28,3,25,10,2.9,21180,53
jackass_the_movie,5.1,93,46,47,49,4.1,17,6,11,35,3.4,50664,78
paid_in_full,5.8,41,21,20,51,5.7,16,7,9,43,4.3,4068,94
truth_about_charlie,4.8,130,43,87,33,4.9,35,14,21,40,2.7,2359,29
1117377-all_or_nothing,7.1,88,73,15,82,6.8,24,18,6,75,3.8,907,82
all_the_queens_men,3.3,29,2,27,6,2.8,11,0,11,0,3.1,969,51
food_of_love,5.3,28,13,15,46,5.4,10,5,5,50,3,360,47
frida,6.9,148,112,36,75,6.8,36,23,13,63,3.7,14440,84
roger_dodger,7.4,121,106,15,87,7.4,30,28,2,93,3.6,1712,75
time_changer,3.9,9,2,7,22,0,1,0,1,0,3.6,571,72
beau_travail,7.6,29,23,6,79,0,4,4,0,100,3.9,709,79
big_knife,0,4,3,1,75,0,0,0,0,0,0,0,0
casino_royale,7.8,214,202,12,94,7.8,43,41,2,95,3.9,155430,87
company_of_wolves,6.5,13,10,3,76,0,1,1,0,100,3.5,2206,71
escanaba_in_da_moonlight,0,3,1,2,33,0,1,0,1,0,0,0,0
1006872-exodus,6,12,8,4,66,0,2,2,0,100,3.6,904,71
how_to_murder_your_wife,5.9,8,5,3,62,0,0,0,0,0,0,0,0
russians_are_coming_the_russians_are_coming,6.8,17,14,3,82,0,1,0,1,0,3.5,861,74
world_of_henry_orient,7.6,8,7,1,87,0,0,0,0,0,0,0,0
hit-me,0,0,0,0,0,0,0,0,0,0,0,0,0
santa_clause_2,5.6,111,61,50,54,5.4,28,13,15,46,2.9,17510,59
blackboards,6.8,34,25,9,73,7.1,11,9,2,81,3.6,447,67
love_in_the_time_of_money,4.2,39,7,32,17,3.1,12,1,11,8,3,203,28
weight_of_water,5.1,62,20,42,32,5.3,21,8,13,38,3,1230,40
1118216-femme_fatale,5.4,133,64,69,48,5.5,32,16,16,50,2.9,3552,49
8_mile,6.7,179,133,46,74,7.2,38,32,6,84,3.1,199023,54
etoiles_dancers_of_the_paris_opera_ballet,6.1,13,8,5,61,6,6,3,3,50,4.4,11,100
far_from_heaven,8.1,188,168,20,89,8.4,37,35,2,94,3.6,5103,77
god_is_great_im_not,4.5,25,6,19,24,4.1,11,1,10,9,3,1107,39
rising_place,4.3,16,2,14,12,3.2,6,0,6,0,3.6,47,75
harry_potter_and_the_chamber_of_secrets,7.1,199,164,35,82,6.6,39,27,12,69,3.6,176055,80
ararat,6.4,75,42,33,56,6.3,22,10,12,45,3.6,923,70
crime_of_padre_amaro,6.2,82,51,31,62,6.3,29,19,10,65,3.7,3433,73
interview_with_the_assassin,6.5,57,38,19,66,6.1,17,10,7,58,3.3,332,52
standing_in_the_shadows_of_motown,7.5,88,81,7,92,7.5,26,24,2,92,4,660,87
way_home,6.6,55,41,14,74,6.5,18,13,5,72,4.2,1280,91
accion-mutante-mutant-action,0,0,0,0,0,0,0,0,0,0,0,0,0
eyes_of_an_angel,0,3,0,3,0,0,0,0,0,0,0,0,0
liberty_stands_still,0,4,0,4,0,0,0,0,0,0,0,0,0
life_and_death_of_colonel_blimp,8.7,11,10,1,90,0,1,1,0,100,4.2,1070,93
rio_grande,6.7,12,9,3,75,0,0,0,0,0,0,0,0
bad_day_at_black_rock,8.2,25,24,1,96,0,3,2,1,66,3.9,1420,86
men_with_brooms,5.6,16,10,6,62,0,3,3,0,100,3.1,1241,61
1014592-mysterious_island,6.2,10,8,2,80,0,0,0,0,0,0,0,0
soul_assassin,0,1,0,1,0,0,0,0,0,0,0,0,0
left_behind_ii_tribulation_force,0,2,0,2,0,0,0,0,0,0,0,0,0
dog_soldiers,6.8,29,22,7,75,0,2,2,0,100,0,0,0
goldfinger,8.4,48,46,2,95,7.9,6,5,1,83,3.6,22155,83
houseboat,5.5,11,6,5,54,0,0,0,0,0,0,0,0
1156538-legion_of_the_dead,0,0,0,0,0,0,0,0,0,0,0,0,0
1042062-madame_bovary,6.4,10,8,2,80,0,1,1,0,100,3.3,531,57
my_fathers_glory,7.5,5,5,0,100,0,2,2,0,100,3.9,1022,84
my_mothers_castle,7.4,7,6,1,85,0,2,1,1,50,4,771,84
return_to_the_blue_lagoon,1.9,20,0,20,0,0,4,0,4,0,2.8,2859,48
too_beautiful_for_you,0,3,3,0,100,0,1,1,0,100,3.5,391,66
1035639-toy_soldiers,4.4,13,5,8,38,0,2,0,2,0,3,3691,57
1016854-prowler,0,3,2,1,66,0,0,0,0,0,0,0,0
pursuit_of_db_cooper,0,0,0,0,0,0,0,0,0,0,0,0,0
raggedy_man,6.5,6,5,1,83,0,1,1,0,100,3.3,201,65
ragtime,7.3,10,9,1,90,0,1,1,0,100,3.5,672,71
1017530-rich_and_famous,4.9,9,5,4,55,0,1,0,1,0,3,151,38
rollover,0,3,2,1,66,0,0,0,0,0,0,0,0
saturday_the_14th,3.4,10,1,9,10,0,0,0,0,0,0,0,0
1018315-scanners,6.8,25,19,6,76,0,4,1,3,25,3.2,5721,61
sharkys_machine,6.2,14,13,1,92,0,1,1,0,100,3,659,45
shock_treatment,5.3,5,2,3,40,0,0,0,0,0,0,0,0
do_you_remember_dolly_bell,0,4,4,0,100,0,0,0,0,0,0,0,0
so_fine,0,4,3,1,75,0,1,1,0,100,2.9,107,15
soupe_aux_choux,0,0,0,0,0,0,0,0,0,0,0,0,0
1019482-southern_comfort,6.7,14,12,2,85,0,1,1,0,100,3.5,1184,72
1019612-sphinx,0,0,0,0,0,0,0,0,0,0,0,0,0
storie-di-ordinaria-follia-tales-of-ordinary-madness,0,0,0,0,0,0,0,0,0,0,0,0,0
student_bodies,3.2,6,1,5,16,0,0,0,0,0,0,0,0
take_this_job_and_shove_it,0,1,0,1,0,0,0,0,0,0,0,0,0
1020896-tarzan_the_ape_man,7.8,13,13,0,100,0,0,0,0,0,0,0,0
10001956-tattoo,6.5,25,17,8,68,6.6,9,6,3,66,3.4,520,60
they_all_laughed,5.2,6,2,4,33,0,0,0,0,0,0,0,0
1028714-thief_of_bagdad,8.1,13,13,0,100,0,1,1,0,100,3.6,655,75
elvis_the_movie,0,2,1,1,50,0,0,0,0,0,0,0,0
true_confessions,7.5,6,6,0,100,0,1,1,0,100,3.3,674,55
revolution-9,6.5,25,19,6,76,6,5,4,1,80,3.3,37,57
die_another_day,6.1,190,112,78,58,5.6,36,15,21,41,3.1,29585,53
emperors_club,5.8,125,63,62,50,5.7,30,14,16,46,3.3,5179,66
friday_after_next,4.1,69,17,52,24,4.5,23,7,16,30,3.3,23508,76
personal_velocity,6.5,99,68,31,68,7.3,28,22,6,78,3.4,664,61
1118347-quiet_american,7.7,150,131,19,87,8,35,33,2,94,3.5,2910,69
con-man,0,0,0,0,0,0,0,0,0,0,0,0,0
adam_sandlers_eight_crazy_nights,3.1,105,13,92,12,3.3,30,4,26,13,3.1,18784,61
extreme_ops,2.9,65,4,61,6,3.3,18,2,16,11,2.6,1235,33
solyaris,8.3,39,38,1,97,8.2,8,8,0,100,4.1,7425,89
treasure_planet,6.5,140,97,43,69,6.5,33,24,9,72,3.1,9742,64
1115907-1115907-they,4.2,54,20,34,37,3.9,12,4,8,33,2.6,2603,31
chopper_chicks_in_zombietown,0,3,0,3,0,0,0,0,0,0,0,0,0
what_to_do_in_case_of_fire,5.6,24,12,12,50,5.5,8,5,3,62,4,589,84
i_love_you_too,0,0,0,0,0,0,0,0,0,0,0,0,0
another_you,3,8,1,7,12,0,0,0,0,0,0,0,0
borat,8,209,191,18,91,8.1,41,40,1,97,3.4,141091,76
elling,7.1,58,49,9,84,7.3,17,16,1,94,4.1,2002,90
i_spit_on_your_grave,4.9,27,15,12,55,0,0,0,0,0,0,0,0
island_at_the_top_of_the_world,0,3,1,2,33,0,0,0,0,0,0,0,0
last_seduction,7.8,48,45,3,93,7.9,11,11,0,100,3.6,1444,73
1078021-contact,6.8,55,37,18,67,6.5,13,7,6,53,3.1,19572,74
new_waterford_girl,7.4,12,11,1,91,0,2,2,0,100,3.7,582,80
noahs_ark_principle,0,0,0,0,0,0,0,0,0,0,0,0,0
sword_and_the_sorcerer,6.8,5,4,1,80,0,0,0,0,0,0,0,0
zulu,7.2,13,12,1,92,0,2,2,0,100,3.8,4868,89
analyze_that,4.8,145,39,106,26,4.1,32,6,26,18,2.9,11576,45
1118698-empire,4.4,99,21,78,21,4.5,26,5,21,19,3.3,2601,62
1118700-adaptation,8.2,195,177,18,90,8,35,30,5,85,3.6,39757,82
equilibrium,4.8,82,30,52,36,4.5,23,7,16,30,3.7,77822,82
madea-goes-to-jail,4.9,46,12,34,26,4.5,11,3,8,27,3.8,153294,74
visitor_q,5.6,8,4,4,50,0,1,0,1,0,3.8,3392,77
urgh-a-music-war,0,0,0,0,0,0,0,0,0,0,0,0,0
vabank,0,0,0,0,0,0,0,0,0,0,0,0,0
varning-for-jonssonligan,0,0,0,0,0,0,0,0,0,0,0,0,0
vernon_florida,7.9,7,7,0,100,0,0,0,0,0,0,0,0
1022576-victory,5.7,6,4,2,66,0,2,2,0,100,3.5,2887,69
whose_life_is_it_anyway,5.9,5,4,1,80,0,0,0,0,0,0,0,0
zoot_suit,0,3,1,2,33,0,0,0,0,0,0,0,0
alone_in_the_dark,1.7,116,1,115,0,1.7,26,0,26,0,2.1,8641,21
android_apocalypse,0,2,0,2,0,0,0,0,0,0,0,0,0
attack_force_z,0,0,0,0,0,0,0,0,0,0,0,0,0
author_author,0,1,1,0,100,0,0,0,0,0,0,0,0
barbarosa,0,4,4,0,100,0,0,0,0,0,0,0,0
beast_within,0,4,0,4,0,0,0,0,0,0,0,0,0
my_best_friends_wedding,6.5,54,39,15,72,5.9,17,10,7,58,3.3,64013,72
best_little_whorehouse_in_texas,5.1,9,5,4,55,0,1,0,1,0,3.2,2628,68
1002907-border,6.7,9,8,1,88,0,0,0,0,0,0,0,0
brimstone_and_treacle,0,1,1,0,100,0,0,0,0,0,0,0,0
britannia_hospital,6.8,5,3,2,60,0,0,0,0,0,0,0,0
burden_of_dreams,8.6,14,14,0,100,0,2,2,0,100,4.1,903,89
cannery_row,6.2,6,4,2,66,0,1,0,1,0,3.5,328,67
class_of_1984,5.9,10,6,4,60,0,1,1,0,100,3.2,1460,61
come_back_to_the_5_and_dime_jimmy_dean_jimmy_dean,0,0,0,0,0,0,0,0,0,0,0,0,0
danton,7.7,7,6,1,85,0,1,1,0,100,3.8,550,79
deathtrap,6.1,11,7,4,63,0,1,1,0,100,3.5,1117,69
turkish_star_wars,0,2,2,0,100,0,0,0,0,0,0,0,0
eating_raoul,6.7,17,15,2,88,0,1,0,1,0,3.4,1151,67
drumline,6.7,81,66,15,81,7,25,23,2,92,3.2,40552,73
hot_chick,3.8,80,17,63,21,4.1,24,7,17,29,3.1,39910,67
maid_in_manhattan,5.1,144,56,88,38,5.1,32,10,22,31,2.9,39640,53
star_trek_nemesis,5.2,155,57,98,36,5.8,32,14,18,43,3.1,16224,56
about_schmidt,7.7,198,168,30,84,7.9,41,37,4,90,3.1,14978,64
el-bola,7.2,11,10,1,90,0,4,4,0,100,3.9,644,85
evelyn,6.1,106,69,37,65,6.5,29,23,6,79,3.6,1505,76
intacto,6.5,72,52,20,72,5.9,21,13,8,61,3.8,2133,82
jimmy_show,5,10,4,6,40,0,3,0,3,0,2.8,238,30
morvern_callar,7,76,64,12,84,7.3,24,21,3,87,3.6,1321,74
lord_of_the_rings_the_two_towers,8.4,218,210,8,96,8,39,39,0,100,4.1,263598,92
devils-on-the-doorstep,6.8,10,9,1,90,0,4,3,1,75,4.1,530,89
25th_hour,7.1,162,126,36,77,7,35,26,9,74,3.7,25056,83
antwone_fisher,6.9,145,114,31,78,7.1,33,28,5,84,3.6,7166,85
gangs_of_new_york,7.1,200,149,51,74,6.5,42,28,14,66,3.5,35768,76
two_weeks_notice,5.2,118,49,69,41,5.1,30,10,20,33,3,28494,63
wild_thornberrys_movie,6.6,86,68,18,79,6.9,26,22,4,84,2.8,2798,43
narc,7.1,151,126,25,83,6.7,30,22,8,73,3.4,4235,76
bad_influence,6.1,14,10,4,71,0,2,2,0,100,3,751,46
1028554-blue_steel,5.9,16,12,4,75,0,2,2,0,100,2.8,1502,32
body_of_evidence,2.7,33,2,31,6,2.6,8,0,8,0,2.4,1797,30
childrens_hour,7.2,5,5,0,100,0,0,0,0,0,0,0,0
10005666-business,5.8,6,3,3,50,0,0,0,0,0,0,0,0
duellists,7.3,14,14,0,100,0,0,0,0,0,0,0,0
1101255-kiss_before_dying,0,4,3,1,75,0,0,0,0,0,0,0,0
miami_blues,6.5,18,15,3,83,0,2,0,2,0,3,889,45
1037649-my_girl,5.3,12,6,6,50,0,2,1,1,50,3.5,29984,75
1037649-my_girl,5.3,12,6,6,50,0,2,1,1,50,3.5,29984,75
my_neighbor_totoro,8.1,28,25,3,89,0,3,1,2,33,4.3,31390,94
road_to_hong_kong,0,4,3,1,75,0,0,0,0,0,0,0,0
running-time,0,0,0,0,0,0,0,0,0,0,0,0,0
1028714-thief_of_bagdad,8.1,13,13,0,100,0,1,1,0,100,3.6,655,75
1023093-war_and_peace,5,6,3,3,50,0,1,0,1,0,3.5,2121,66
1158918-sleeping_dogs_lie,6.1,50,32,18,64,6.1,14,10,4,71,2.8,1534,38
wheres_poppa,7.4,8,8,0,100,0,1,1,0,100,3.3,354,64
whistle_blower,7.6,7,6,1,85,0,1,1,0,100,3.1,379,36
attack_of_the_crab_monsters,0,1,0,1,0,0,0,0,0,0,0,0,0
black-love,0,0,0,0,0,0,0,0,0,0,0,0,0
1005366-day_of_the_triffids,6.5,15,13,2,86,0,1,1,0,100,3,1136,47
esther-kahn,5.5,24,12,12,50,4.2,8,2,6,25,3.5,245,57
1010672-invaders_from_mars,7,10,8,2,80,0,0,0,0,0,0,0,0
the-story-of-o,0,0,0,0,0,0,0,0,0,0,0,0,0
asoka,7.6,10,10,0,100,0,0,0,0,0,0,0,0
fat_city,8.6,17,17,0,100,8.1,5,5,0,100,3.9,668,84
love_honor_and_obey,4.2,15,4,11,26,2.9,5,0,5,0,4.1,2113,87
quicksilver,3.1,12,1,11,8,0,1,0,1,0,2.8,823,34
catch_me_if_you_can,7.9,191,183,8,95,7.3,42,38,4,90,3.6,77695,81
1016342-pinocchio,9,37,37,0,100,8.5,5,5,0,100,3.3,19102,66
hours,7.4,184,148,36,80,7.1,37,29,8,78,3.7,23176,83
max,6.4,110,76,34,69,6.3,27,19,8,70,3.3,1412,63
1119037-nicholas_nickleby,6.8,120,92,28,76,6.4,30,22,8,73,3.5,2514,72
pianist,8.2,177,169,8,95,8.1,35,33,2,94,4,55875,94
sonny,4.2,26,6,20,23,4.2,8,2,6,25,3,1479,43
champagne_for_caesar,0,3,3,0,100,0,0,0,0,0,0,0,0
journey_to_the_far_side_of_the_sun,0,4,1,3,25,0,0,0,0,0,0,0,0
heavy_metal_2000,3.7,9,0,9,0,0,1,0,1,0,2.9,2857,44
house_on_the_edge_of_the_park,0,3,1,2,33,0,0,0,0,0,0,0,0
1011623-king_of_comedy,8.3,39,36,3,92,7,5,4,1,80,3.8,6225,84
love_liza,5.9,85,46,39,54,5.6,24,13,11,54,3.7,1656,76
abrahams_valley,7.3,6,5,1,83,0,2,2,0,100,3.7,181,69
blue_collar_comedy_tour_the_movie,6.8,13,12,1,92,7,8,8,0,100,3.6,6829,82
just-married-marriage-was-only-the-beginning,0,0,0,0,0,0,0,0,0,0,0,0,0
ps_your_cat_is_dead,4.2,17,4,13,23,4.1,8,1,7,12,3.1,453,48
the-son-le-fils,0,0,0,0,0,0,0,0,0,0,0,0,0
1110769-city_of_lost_souls,5.4,12,7,5,58,0,2,1,1,50,3.2,791,48
double_whammy,4.5,10,3,7,30,0,0,0,0,0,0,0,0
wisegirls2002,0,0,0,0,0,0,0,0,0,0,0,0,0
guy_thing,4.1,97,24,73,24,3.8,27,5,22,18,2.8,8292,37
1136750-jack,0,0,0,0,0,0,0,0,0,0,0,0,0
national_security,3.3,87,10,77,11,4,26,6,20,23,3,10503,55
big_shots_funeral,4.7,15,3,12,20,0,1,0,1,0,3.6,201,72
city_of_god,8.3,149,137,12,91,8.2,34,31,3,91,4.3,66456,97
1119800-divine_intervention,7.2,68,55,13,80,7.6,19,18,1,94,3.7,616,76
kiras_reason_a_love_story,5.7,18,12,6,66,0,4,1,3,25,3.7,143,64
investigation_of_a_citizen_above_suspicion,7.9,5,5,0,100,0,3,3,0,100,4.4,483,97
alice_adams,7.8,14,13,1,92,0,3,3,0,100,3.6,789,67
american_friend,7.2,16,14,2,87,0,2,2,0,100,3.8,1218,80
american_me,6.8,8,5,3,62,0,2,2,0,100,4.1,2720,91
band_of_outsiders,7.9,39,37,2,94,7.7,12,12,0,100,4.2,4082,91
break_up,5,187,62,125,33,4.5,40,8,32,20,3.1,107481,52
cb4,5.7,20,11,9,55,4.8,7,2,5,28,3.1,2278,60
deathmaker,0,0,0,0,0,0,0,0,0,0,0,0,0
1036458-dogfight,6.8,15,12,3,80,0,2,1,1,50,3.8,1613,83
1008358-girls_girls_girls,4.9,5,2,3,40,0,0,0,0,0,0,0,0
1010417-imitation_of_life,7.4,13,11,2,84,0,1,1,0,100,4.2,2834,91
1012506-little_romance,6.7,14,11,3,78,0,1,0,1,0,3.8,1363,79
mystery_date,4.7,8,2,6,25,0,1,0,1,0,2.9,538,41
pepe-le-moko,8.6,29,29,0,100,8.8,11,11,0,100,3.8,713,82
secret_admirer,4.1,8,2,6,25,0,0,0,0,0,0,0,0
summer_lovers,0,4,0,4,0,0,1,0,1,0,3.1,495,47
tune_in_tomorrow,6,11,5,6,45,6.2,5,2,3,40,3,665,42
woman_in_red,4.3,7,2,5,28,0,0,0,0,0,0,0,0
darkness_falls,3.2,124,10,114,8,3,25,1,24,4,2.8,11135,46
amen,6.3,49,33,16,67,6.1,15,9,6,60,3.9,1385,82
blind_spot_hitlers_secretary,7.3,80,68,12,85,7.7,27,26,1,96,3.4,472,66
in_the_mirror_of_maya_deren,8,18,17,1,94,7.8,7,7,0,100,3.8,258,79
1002571-blind_date,4.1,22,5,17,22,0,3,1,2,33,2.9,2983,44
love_and_a_bullet,0,2,0,2,0,0,0,0,0,0,0,0,0
1005412-dead_reckoning,6.2,6,4,2,66,0,0,0,0,0,0,0,0
devil_at_4_oclock,0,3,2,1,66,0,0,0,0,0,0,0,0
ethan_frome,5.7,9,5,4,55,0,2,1,1,50,2.9,406,40
milk,8,217,203,14,93,8.3,38,36,2,94,3.9,55245,88
harder_they_come,7.6,13,11,2,84,0,1,0,1,0,3.9,1321,84
horse_in_the_gray_flannel_suit,0,0,0,0,0,0,0,0,0,0,0,0,0
krush_groove,0,4,3,1,75,0,0,0,0,0,0,0,0
moonspinners,0,2,1,1,50,0,0,0,0,0,0,0,0
1048585-sugar_hill,5.1,9,2,7,22,0,1,0,1,0,3.4,1056,71
10006150-chaos,0,4,1,3,25,0,0,0,0,0,0,0,0
biker_boyz,4.2,90,20,70,22,4,28,6,22,21,3,10252,59
final_destination_2,5,106,50,56,47,4,23,7,16,30,3.2,47391,70
recruit,5.5,163,70,93,42,5.6,35,16,19,45,3.2,15473,63
1119875-guru,5.7,87,50,37,57,5.6,25,15,10,60,2.6,2775,39
kedma,4.8,13,4,9,30,0,2,0,2,0,3.4,166,53
lost_in_la_mancha,7.5,97,91,6,93,7.4,25,22,3,88,3.6,5216,72
may,6.1,63,43,20,68,5.1,16,7,9,43,3.5,5807,75
1009224-harder_they_fall,7.4,9,9,0,100,0,0,0,0,0,0,0,0
im_all_right_jack,8,5,5,0,100,0,0,0,0,0,0,0,0
murder_by_decree,6.9,7,6,1,85,0,0,0,0,0,0,0,0
ordinary-decent-criminal,3.7,7,1,6,14,0,0,0,0,0,0,0,0
pursued,0,0,0,0,0,0,0,0,0,0,0,0,0
tokyo_decadence,6.6,5,3,2,60,0,1,0,1,0,3.4,394,61
unfaithful_wife,0,3,3,0,100,0,0,0,0,0,0,0,0
tenth_victim,0,4,4,0,100,0,0,0,0,0,0,0,0
10009001-the_freshman,7.3,32,30,2,93,7.2,8,7,1,87,3.1,2525,52
den-enfaldige-mordaren-the-simpleminded-murder,0,0,0,0,0,0,0,0,0,0,0,0,0
1113649-enigma,6.6,104,75,29,72,6.8,29,22,7,75,3.2,2061,52
evil_under_the_sun,6.5,6,5,1,83,0,1,1,0,100,3.4,1485,61
firefox,5.2,12,5,7,41,0,1,1,0,100,2.9,3121,39
five_days_one_summer,4,5,1,4,20,0,2,0,2,0,3,98,41
forced_vengeance,0,0,0,0,0,0,0,0,0,0,0,0,0
gendarme-et-les-gendarmettes-le,0,0,0,0,0,0,0,0,0,0,0,0,0
grey_fox,7.1,12,12,0,100,0,1,1,0,100,3.5,162,64
hammett,5.2,8,6,2,75,0,0,0,0,0,0,0,0
honkytonk_man,7,14,13,1,92,0,4,3,1,75,3.2,1335,52
1010263-i_the_jury,0,4,1,3,25,0,0,0,0,0,0,0,0
if_you_could_see_what_i_hear,0,0,0,0,0,0,0,0,0,0,0,0,0
jekyll_and_hyde_together_again,0,0,0,0,0,0,0,0,0,0,0,0,0
jonssonligan-dynamitharry,0,0,0,0,0,0,0,0,0,0,0,0,0
kiss_me_goodbye,0,1,1,0,100,0,0,0,0,0,0,0,0
labyrinth_of_passion,7.8,6,6,0,100,0,4,4,0,100,0,0,0
last_american_virgin,5.8,9,6,3,66,0,1,0,1,0,3.3,3330,60
last_unicorn,5.8,10,5,5,50,0,0,0,0,0,0,0,0
liquid_sky,6.9,17,16,1,94,0,3,3,0,100,3.5,1091,67
dragon_lord,0,4,3,1,75,0,0,0,0,0,0,0,0
making_love,4.6,16,5,11,31,0,3,0,3,0,3.4,534,61
manhattan_baby,0,2,0,2,0,0,0,0,0,0,0,0,0
megaforce,1.4,7,0,7,0,0,0,0,0,0,0,0,0
midsummer_nights_sex_comedy,6.3,21,15,6,71,0,4,0,4,0,3.3,2757,58
1127407-missing,6.1,168,98,70,58,6.1,39,21,18,53,3,6895,52
1014027-mission,6.4,16,11,5,68,0,2,1,1,50,3.8,11307,83
monsignor,1.9,5,0,5,0,0,3,0,3,0,2.1,20,0
monty_python_live_at_the_hollywood_bowl,0,2,2,0,100,0,0,0,0,0,0,0,0
mother_lode,0,0,0,0,0,0,0,0,0,0,0,0,0
night_of_the_shooting_stars,6.8,9,6,3,66,0,1,0,1,0,3.8,345,72
la_nuit_de_varennes,0,4,3,1,75,0,1,0,1,0,3.9,168,78
one_from_the_heart,5.8,27,13,14,48,5.9,11,6,5,54,3.4,725,61
pandemonium,0,0,0,0,0,0,0,0,0,0,0,0,0
1015925-paradise,0,3,0,3,0,0,0,0,0,0,0,0,0
partners2005,0,0,0,0,0,0,0,0,0,0,0,0,0
1082980-passion,6.2,6,4,2,66,0,1,1,0,100,3.5,398,61
1203530-permanent_vacation,0,0,0,0,0,0,0,0,0,0,0,0,0
personal_best,6.4,22,16,6,72,5.5,5,2,3,40,3.3,320,58
pirates_of_the_caribbean_the_curse_of_the_black_pearl,7.1,196,153,43,78,6.4,38,25,13,65,3.9,297546,86
privates_on_parade,0,1,0,1,0,0,0,0,0,0,0,0,0
blind-chance,7.6,6,5,1,83,0,0,0,0,0,0,0,0
le-pere-noel-est-une-orduresanta-claus-is-a-louse,0,0,0,0,0,0,0,0,0,0,0,0,0
q,0,0,0,0,0,0,0,0,0,0,0,0,0
querelle,5.2,9,5,4,55,0,1,0,1,0,3.7,843,71
richard_pryor_live_on_sunset_strip,8.8,13,13,0,100,0,1,1,0,100,3.7,1438,82
sans_soleil,7.4,10,9,1,90,0,1,1,0,100,4.3,1016,89
savannah_smiles,0,1,0,1,0,0,0,0,0,0,0,0,0
secret_policemans_other_ball,0,4,4,0,100,0,0,0,0,0,0,0,0
veronika_voss,7.4,8,6,2,75,0,3,2,1,66,4.1,643,87
shoot_the_moon,7.8,8,8,0,100,0,1,1,0,100,3.7,260,64
six_weeks,0,0,0,0,0,0,0,0,0,0,0,0,0
1083934-soldier,3.5,50,5,45,10,3.6,15,2,13,13,2.8,5503,46
some_kind_of_hero,0,0,0,0,0,0,0,0,0,0,0,0,0
new_york_ripper,0,4,0,4,0,0,0,0,0,0,0,0,0
state_of_things,0,4,2,2,50,0,0,0,0,0,0,0,0
1020035-starstruck,0,1,1,0,100,0,0,0,0,0,0,0,0
still_of_the_night,5.8,6,4,2,66,0,0,0,0,0,0,0,0
sword_of_the_valiant,0,1,0,1,0,0,0,0,0,0,0,0,0
tag_the_assassination_game,0,1,1,0,100,0,0,0,0,0,0,0,0
1087280-tempest,0,4,3,1,75,0,0,0,0,0,0,0,0
tenebre,6.7,15,11,4,73,0,0,0,0,0,0,0,0
1196557-my_name_is_bruce,4.8,42,17,25,40,4.2,11,3,8,27,3.2,5111,50
time_walker,0,0,0,0,0,0,0,0,0,0,0,0,0
trail_of_the_pink_panther,3.8,11,3,8,27,0,0,0,0,0,0,0,0
traviata-la,0,0,0,0,0,0,0,0,0,0,0,0,0
1151780-venom,3.1,62,6,56,9,3.5,19,3,16,15,2.6,2557,30
white_rose,0,0,0,0,0,0,0,0,0,0,0,0,0
white_dog,7.6,10,9,1,90,0,0,0,0,0,0,0,0
1007329-final_option,0,0,0,0,0,0,0,0,0,0,0,0,0
wrong_is_right,5.1,8,3,5,37,0,2,0,2,0,3,305,38
yol,0,1,1,0,100,0,0,0,0,0,0,0,0
yor_the_hunter_from_the_future,2.8,5,1,4,20,0,0,0,0,0,0,0,0
zapped,2,10,0,10,0,0,1,0,1,0,2.8,878,42
deliver_us_from_eva,5.4,81,35,46,43,5.3,28,12,16,42,3.5,3415,78
how_to_lose_a_guy_in_10_days,5,145,62,83,42,4.9,34,12,22,35,3.4,131729,78
shanghai_knights,6,145,95,50,65,6.2,32,23,9,71,3.1,25826,63
daredevil,5.2,210,93,117,44,4.4,35,9,26,25,2.8,46864,46
jungle_book_2,4.4,85,16,69,18,4.1,25,4,21,16,2.9,4176,48
all_the_real_girls,6.9,110,78,32,70,6.7,29,22,7,75,3.9,2897,80
amandla-a-revolution-in-four-part-harmony,7.1,61,50,11,81,7.6,17,15,2,88,4,313,86
chihwaseon,0,0,0,0,0,0,0,0,0,0,0,0,0
jerry_maguire,7.4,57,48,9,84,7.5,19,17,2,89,3.3,32601,72
he_loves_me_he_loves_me_not,6.8,71,52,19,73,6.9,24,18,6,75,3.8,6623,82
dennis_the_menace,3.9,22,5,17,22,4.9,7,2,5,28,2.7,11273,44
ten_to_midnight,0,4,1,3,25,0,0,0,0,0,0,0,0
black_stallion_returns,0,2,0,2,0,0,1,0,1,0,3.5,1102,77
black_stallion,7.7,21,18,3,85,6,5,3,2,60,3.2,3574,76
countess_from_hong_kong,0,4,2,2,50,0,0,0,0,0,0,0,0
1046771-into_the_west,6.4,10,7,3,70,0,2,1,1,50,3.6,744,73
kinjite_forbidden_subjects,3.6,6,0,6,0,0,1,0,1,0,3,491,40
messenger_of_death,0,0,0,0,0,0,0,0,0,0,0,0,0
mr_majestyk,6,8,6,2,75,0,0,0,0,0,0,0,0
murphys_law,0,3,1,2,33,0,0,0,0,0,0,0,0
patch_of_blue,8,5,5,0,100,0,0,0,0,0,0,0,0
prayer_for_the_dying,5.3,8,5,3,62,0,1,0,1,0,3.1,695,51
q,0,0,0,0,0,0,0,0,0,0,0,0,0
red_badge_of_courage,7.6,9,8,1,88,0,0,0,0,0,0,0,0
thrill_of_it_all,0,2,1,1,50,0,0,0,0,0,0,0,0
pillow_talk,7.1,23,21,2,91,0,3,2,1,66,3.8,3898,85
man_who_fell_to_earth,7.8,22,19,3,86,6.8,5,3,2,60,3.6,3805,71
dark_blue,5.8,127,73,54,57,5.8,32,18,14,56,3.1,2377,50
gods_and_generals,3.5,119,9,110,7,3.5,29,1,28,3,3.5,2681,67
life_of_david_gale,4.2,153,30,123,19,4.1,36,5,31,13,3.6,17064,81
old_school,5.6,165,99,66,60,5.4,31,16,15,51,3.7,85493,84
lawless_heart,7.1,51,43,8,84,7.2,22,19,3,86,3.6,186,59
1120811-navigators,7.3,10,10,0,100,0,3,3,0,100,3.6,355,75
open_hearts,7.6,55,53,2,96,7.4,16,15,1,93,4.1,1075,88
poolhall_junkies,4.6,44,15,29,34,4.1,12,2,10,16,3.9,3976,87
till_human_voices_wake_us,4.9,70,17,53,24,4.8,23,4,19,17,3.6,697,68
stone_reader,7.2,64,53,11,82,7.3,22,18,4,81,3.5,316,66
cradle_2_the_grave,4.5,118,31,87,26,4.3,24,8,16,33,3.2,15487,61
1120292-spider,7.5,126,107,19,84,7.6,34,30,4,88,3.3,4398,67
american_heart,6.4,8,6,2,75,0,1,1,0,100,3.4,430,61
edie_and_pen,0,0,0,0,0,0,0,0,0,0,0,0,0
insignificance,6.6,8,7,1,87,0,1,1,0,100,3.7,200,70
lady_jane,5.4,7,4,3,57,0,0,0,0,0,0,0,0
late_marriage,7.3,64,56,8,87,8,21,21,0,100,3.7,332,74
life_stinks,3.9,15,3,12,20,0,1,1,0,100,2.9,1450,44
meteor_man,4.3,14,4,10,28,0,3,0,3,0,2.4,857,36
mr_north,5.6,7,3,4,42,0,1,0,1,0,2.8,95,29
dead_poets_society,7.2,49,42,7,85,6.5,7,5,2,71,3.8,56733,90
slaughter_rule,5.9,25,17,8,68,5.6,6,4,2,66,3.1,349,44
teenagers_from_outer_space,0,4,1,3,25,0,0,0,0,0,0,0,0
trouble_bound,0,4,1,3,25,0,0,0,0,0,0,0,0
volcano-high2003,0,0,0,0,0,0,0,0,0,0,0,0,0
enchanted,7.3,157,145,12,92,7.4,34,31,3,91,3.8,188655,80
bringing_down_the_house,4.7,144,49,95,34,4.8,32,12,20,37,3.1,17625,60
tears_of_the_sun,5,148,50,98,33,4.8,36,13,23,36,3.4,24615,72
laurel_canyon,6.4,108,73,35,67,6.6,30,20,10,66,3.2,2829,52
nowhere-in-africa,7.5,97,83,14,85,7.6,30,25,5,83,4,1773,88
the-safety-of-objects,5.9,72,35,37,48,5.5,27,11,16,40,3.5,1184,68
bend_it_like_beckham,7.2,147,125,22,85,6.9,32,26,6,81,3.2,49098,69
1120843-hunted,4.7,143,44,99,30,4.5,34,10,24,29,3,5362,51
willard,6.2,124,80,44,64,5.7,27,15,12,55,2.9,3602,49
gaudi_afternoon,4.7,17,5,12,29,3.2,6,0,6,0,3.1,152,40
prozac-nation,4.6,23,6,17,26,4.5,5,2,3,40,3.3,5783,61
spun,4.7,77,28,49,36,4.1,23,4,19,17,3.5,14251,74
under_the_skin_of_the_city,7,30,26,4,86,7.5,12,11,1,91,3.6,242,72
1011626-king_of_kings,6.2,14,11,3,78,0,4,2,2,50,3.7,879,75
die-verlorene-ehre-der-katharina-blum-oder-wie-gewalt-entstehen-und-wohin-sie-fuhren-kann,7.2,9,8,1,88,0,1,0,1,0,3.9,286,83
talk_of_the_town,7.4,14,13,1,92,0,2,2,0,100,3.8,815,83
twolane-blacktop,7.5,25,23,2,92,7.6,5,5,0,100,3.9,1567,83
1001634-bang_the_drum_slowly,7.4,24,21,3,87,0,3,3,0,100,3.4,1003,62
benny_goodman_story,0,2,2,0,100,0,0,0,0,0,0,0,0
born_free,6.6,10,9,1,90,0,0,0,0,0,0,0,0
1002930-born_yesterday,8.1,20,19,1,95,0,2,1,1,50,3.9,1132,86
equus,6,14,9,5,64,0,0,0,0,0,0,0,0
europa_europa,7.5,14,14,0,100,0,1,1,0,100,4.1,1867,90
fear_strikes_out,6.3,10,7,3,70,0,0,0,0,0,0,0,0
glenn_miller_story,7.3,8,7,1,87,0,0,0,0,0,0,0,0
green_card,5.4,17,9,8,52,0,2,2,0,100,2.8,3609,45
10008588-journey_3d,6,148,91,57,61,6.6,31,24,7,77,3.2,38002,55
one_good_cop,4.4,11,2,9,18,0,2,0,2,0,2.8,845,32
pauline_at_the_beach,8.8,8,8,0,100,0,2,2,0,100,3.8,644,82
ghost-hole,0,0,0,0,0,0,0,0,0,0,0,0,0
ringu_2,3.6,14,0,14,0,4.2,5,0,5,0,3.2,2782,55
salaam_bombay,7.9,12,11,1,91,0,3,3,0,100,4.1,1353,91
sweet_charity,0,3,3,0,100,0,0,0,0,0,0,0,0
1172784-women_in_love,0,0,0,0,0,0,0,0,0,0,0,0,0
japon,7.4,25,20,5,80,8.1,8,8,0,100,3.7,545,72
boat_trip,2.6,87,6,81,6,3,22,2,20,9,2.7,8176,44
piglets_big_movie,6.3,74,54,20,72,6,22,14,8,63,3.4,1599,66
view_from_the_top,3.7,122,17,105,13,3.6,30,3,27,10,2.6,4839,36
awful_truth,8,23,21,2,91,0,2,2,0,100,4,2109,88
for_the_bible_tells_me_so,7.5,47,46,1,97,7.6,16,16,0,100,4.1,1345,89
house_with_laughing_windows,0,2,2,0,100,0,0,0,0,0,0,0,0
i_am_curious_blue,5.2,24,12,12,50,0,4,2,2,50,3.6,513,64
les-dames-du-bois-de-boulogne-ladies-of-the-park,8.3,12,12,0,100,0,2,2,0,100,3.8,470,77
flicka,5.7,76,41,35,53,5.6,24,12,12,50,3.7,22360,82
black_robe,7,12,11,1,91,0,1,0,1,0,3.3,1641,60
1040484-wind,5.8,10,5,5,50,0,2,2,0,100,3.5,661,71
unknown_pleasures,6.6,27,17,10,62,6.2,7,5,2,71,3.5,432,67
basic,4.5,141,30,111,21,4.8,34,8,26,23,3.2,9571,66
core,5.3,150,63,87,42,5.3,31,14,17,45,2.7,16895,41
head_of_state,4.8,116,35,81,30,4.8,26,7,19,26,2.8,5662,51
what_a_girl_wants,4.8,103,35,68,33,4.5,27,6,21,22,3.2,68538,67
assassination_tango,5.6,87,42,45,48,6,29,14,15,48,2.9,572,37
raising_victor_vargas,7.9,105,101,4,96,8,31,31,0,100,3.8,1155,81
yves-st-laurent-his-life-and-times,6.3,14,10,4,71,5.9,9,6,3,66,3.8,65,81
1030577-dreams,5.8,17,9,8,52,5.4,5,3,2,60,4.1,4853,87
day_for_night,8.6,22,22,0,100,0,2,2,0,100,4.1,2313,90
eye_of_god,6.8,12,10,2,83,0,2,2,0,100,3.9,140,82
in_a_lonely_place,8.5,28,28,0,100,0,4,4,0,100,4,1654,87
physical_evidence,3.3,16,2,14,12,0,4,0,4,0,2.6,340,19
square_dance,0,3,0,3,0,0,1,0,1,0,3.2,289,48
wake_of_the_red_witch,0,2,2,0,100,0,0,0,0,0,0,0,0
winter-kills,7,14,12,2,85,0,3,2,1,66,3.3,254,49
fellini-im-a-born-liar,6.6,40,29,11,72,6.4,12,8,4,66,3.3,437,59
good_thief,6.8,138,107,31,77,7,36,29,7,80,3.2,1301,58
man_apart,4,129,14,115,10,3.9,31,3,28,9,3.4,15785,68
phone_booth,6.6,184,131,53,71,6.2,35,22,13,62,3.1,27495,63
cet-amour-la,0,0,0,0,0,0,0,0,0,0,0,0,0
cowboy_bebop_the_movie,6.3,69,45,24,65,6.4,19,11,8,57,3.9,8587,89
dysfunktional_family,5.2,63,27,36,42,5.2,19,9,10,47,3.7,483,73
levity,5.3,87,31,56,35,4.9,29,7,22,24,3,1220,44
man_without_a_past,8,92,90,2,97,8.2,29,29,0,100,4,2471,90
1121649-anger_management,5.1,188,81,107,43,5.1,39,18,21,46,3.3,70407,66
better_luck_tomorrow,7,95,76,19,80,6.8,32,24,8,75,3.6,1992,76
ghosts_of_the_abyss,7.1,94,76,18,80,7.1,24,21,3,87,3.3,1345,60
house_of_1000_corpses,3.3,77,13,64,16,2.6,13,0,13,0,3.2,25214,68
lilya_4ever,7.6,67,58,9,86,7.8,24,23,1,95,4.1,4008,90
marion_bridge,6.2,16,12,4,75,6.3,8,6,2,75,3.3,388,58
xx_xy,5.3,61,27,34,44,5.3,26,12,14,46,3.1,728,44
bulletproof_monk,4.3,130,28,102,21,4,31,5,26,16,2.9,13789,50
chasing_papi,3.7,47,6,41,12,3.9,20,3,17,15,2.8,1064,43
mighty_wind,7.4,171,150,21,87,7.4,38,33,5,86,3.6,7120,81
holes,7,132,102,30,77,6.9,33,24,9,72,3.3,16191,72
malibus_most_wanted,4.6,91,27,64,29,4.2,27,4,23,14,2.6,6955,54
winged_migration,8.2,126,121,5,96,8.4,36,36,0,100,4,1576,85
flickering_lights,6.3,10,7,3,70,0,4,2,2,50,4.3,1010,92
straw_dogs,8.4,30,28,2,93,0,4,2,2,50,3.8,5295,82
1034431-beginning_of_the_end,0,4,2,2,50,0,0,0,0,0,0,0,0
the-andromeda-strain2008,0,2,1,1,50,0,0,0,0,0,0,0,0
brainscan,4,10,2,8,20,0,2,0,2,0,3.1,1960,56
1007003-fahrenheit_451,7.5,29,25,4,86,0,3,1,2,33,3.5,5957,70
i_am_trying_to_break_your_heart,6.9,59,52,7,88,6.7,20,18,2,90,4,998,88
1120594-iceman_cometh,6.9,8,7,1,87,6.9,5,4,1,80,3.8,322,67
legal_eagles,5.2,14,7,7,50,0,1,0,1,0,2.8,875,32
married_to_it,4.6,10,3,7,30,0,2,0,2,0,2.9,355,33
memories_of_me,0,2,1,1,50,0,1,1,0,100,2.9,313,40
other_side_of_heaven,4.6,41,11,30,26,4,12,1,11,8,3.6,2400,74
private_function,0,3,3,0,100,0,0,0,0,0,0,0,0
1030709-sibling_rivalry,3.5,8,1,7,12,0,2,0,2,0,2.8,481,33
undercover_blues,5,17,6,11,35,0,4,1,3,25,3,1603,56
wildcats,3.9,16,2,14,12,0,3,0,3,0,3.1,1616,51
wiz,4.7,19,7,12,36,0,0,0,0,0,0,0,0
cartouche,0,0,0,0,0,0,0,0,0,0,0,0,0
marrying_man,3.2,14,1,13,7,0,2,1,1,50,2.7,603,36
mon-pere-ce-heros,0,0,0,0,0,0,0,0,0,0,0,0,0
scenes_from_a_mall,4.3,23,7,16,30,3.7,6,2,4,33,2.6,1017,29
how_stella_got_her_groove_back,5.5,47,23,24,48,5.8,12,7,5,58,3.1,4439,72
confidence,6.3,150,106,44,70,6.1,40,25,15,62,3.4,3860,69
identity,6.4,166,103,63,62,6.1,35,20,15,57,3.4,21479,76
it_runs_in_the_family,4.5,95,27,68,28,4.6,29,11,18,37,2.7,901,32
real_cancun,4.2,86,30,56,34,4.4,22,8,14,36,2.2,744,28
city_of_ghosts,5.5,66,31,35,46,5.8,23,11,12,47,3.1,795,45
decade_under_the_influence,6.7,30,23,7,76,6.9,12,9,3,75,3.8,1167,80
house_of_fools,5,47,18,29,38,4.9,18,7,11,38,3.8,736,79
people_i_know,5.4,51,22,29,43,5.7,17,7,10,41,2.9,1615,35
1019609-spellbound,7.3,30,26,4,86,0,1,1,0,100,3.8,4332,82
lizzie_mcguire_movie,5.4,96,38,58,39,5.7,29,16,13,55,2.7,32236,57
x2_xmen_united,7.4,221,194,27,87,6.9,40,33,7,82,3.7,110058,84
blue_car,6.9,85,69,16,81,7.2,33,30,3,90,3.3,652,62
dancer_upstairs,6.4,112,71,41,63,6.6,35,26,9,74,3.6,1196,73
marooned_in_iraq,7.6,27,25,2,92,8.1,10,10,0,100,3.9,152,81
owning_mahowny,7,93,73,20,78,6.8,31,24,7,77,3.5,1339,71
daddy_day_care,4.5,124,35,89,28,4.6,34,9,25,26,3.2,35165,63
man_on_the_train,7.5,109,100,9,91,7.6,35,33,2,94,3.7,1127,79
only_the_strong_survive,5.9,44,27,17,61,6.1,22,15,7,68,3.3,234,51
shape_of_things,6.3,134,86,48,64,5.7,39,20,19,51,3.4,2043,64
1097259-road_trip,5.9,89,52,37,58,5.9,21,14,7,66,3.3,57286,68
washington_heights,6.1,38,30,8,78,6,15,12,3,80,3.3,157,57
101_reykjavik,7,46,41,5,89,7.5,11,10,1,90,3.6,2003,71
chorus_line,4.8,14,6,8,42,0,1,1,0,100,3.4,2567,64
absolute_beginners,5.9,7,6,1,85,0,0,0,0,0,0,0,0
beat_street,0,4,1,3,25,0,0,0,0,0,0,0,0
electric_boogaloo_breakin_2,0,3,1,2,33,0,1,1,0,100,3.4,1507,66
breakin,4,6,2,4,33,0,0,0,0,0,0,0,0
castle-in-the-sky,7.2,17,16,1,94,0,2,1,1,50,4.1,25837,89
hysterical_blindness,5.4,10,7,3,70,0,3,2,1,66,0,0,0
1011825-lambada,0,0,0,0,0,0,0,0,0,0,0,0,0
roadie,0,4,0,4,0,0,1,0,1,0,3.2,251,55
carpetbaggers,5.6,6,3,3,50,0,0,0,0,0,0,0,0
les_girls,0,4,4,0,100,0,0,0,0,0,0,0,0
gunfight_at_the_ok_corral,6.9,11,9,2,81,0,0,0,0,0,0,0,0
high_society,6.7,15,11,4,73,0,2,1,1,50,3.8,2979,82
kiss-me-kate1953,7,10,8,2,80,0,2,1,1,50,3.6,1732,73
matrix_reloaded,6.8,233,171,62,73,6.5,43,31,12,72,3.4,124014,74
dracula_pages_from_a_virgins_diary,7.4,59,51,8,86,7.8,21,19,2,90,3.5,898,70
down_by_love,8.3,5,5,0,100,0,1,1,0,100,3.3,44,67
cinemania,6.8,37,32,5,86,7.3,10,9,1,90,3.3,411,59
friends_and_family,4.4,18,8,10,44,4,6,2,4,33,3.5,319,64
auberge_espagnol,6.5,89,68,21,76,6.7,32,27,5,84,3.9,9251,85
pokemon-heroes,3.6,37,6,31,16,3.7,14,4,10,28,3.4,3562,65
evan_almighty,4.5,190,44,146,23,4,39,3,36,7,3.2,369422,56
inlaws,4.9,126,44,82,34,4.9,35,12,23,34,2.9,2546,42
gigantic_a_tale_of_two_johns,7.1,45,37,8,82,7,19,16,3,84,4,397,88
respiro,6.6,84,64,20,76,6.5,26,19,7,73,3.9,757,82
finding_nemo,8.5,198,195,3,98,8.5,40,40,0,100,3.8,252174,80
italian_job,6.4,178,129,49,72,6.7,40,32,8,80,3.6,103062,79
wrong_turn,4.3,77,31,46,40,3.7,13,3,10,23,3.1,24686,63
capturing_the_friedmans,8.4,146,142,4,97,8.4,39,38,1,97,3.9,2794,87
together,6.7,77,56,21,72,6.7,26,20,6,76,4.1,1005,88
2_fast_2_furious,4.8,155,56,99,36,4.8,33,13,20,39,3.1,176485,59
love_the_hard_way,4.8,43,12,31,27,4.8,20,5,15,25,3.6,697,66
whale_rider,7.7,143,129,14,90,7.5,35,30,5,85,3.8,9564,87
nevada_smith,6.5,6,4,2,66,0,0,0,0,0,0,0,0
1068208-once_a_thief,6.5,5,3,2,60,0,0,0,0,0,0,0,0
regeneration_1998,0,0,0,0,0,0,0,0,0,0,0,0,0
silk_stockings,0,4,4,0,100,0,0,0,0,0,0,0,0
snowball_express,0,0,0,0,0,0,0,0,0,0,0,0,0
man_called_horse,6.9,14,12,2,85,0,0,0,0,0,0,0,0
big_jake,0,4,4,0,100,0,0,0,0,0,0,0,0
movie_crazy,0,1,0,1,0,0,0,0,0,0,0,0,0
dementia_13,5.7,17,10,7,58,0,1,0,1,0,3,1086,41
drole-de-drame,6.6,9,7,2,77,0,2,2,0,100,3.8,73,76
le_mans,5.8,6,3,3,50,0,0,0,0,0,0,0,0
murder_on_a_sunday_morning,0,3,2,1,66,0,0,0,0,0,0,0,0
rio_lobo,6.1,19,14,5,73,0,3,1,2,33,3.7,1553,75
siam_sunset,6,8,5,3,62,0,2,1,1,50,3.6,119,67
swimmer,7.7,18,18,0,100,0,3,3,0,100,3.8,683,79
1023567-white_sheik,7.8,11,11,0,100,0,1,1,0,100,3.6,726,74
1021966-treasure_island,0,0,0,0,0,0,0,0,0,0,0,0,0
two_evil_eyes,5.2,9,4,5,44,0,0,0,0,0,0,0,0
walk_dont_run,6.4,5,4,1,80,0,0,0,0,0,0,0,0
animals-are-beautiful-people-capricorns-beautiful-people,0,2,2,0,100,0,0,0,0,0,0,0,0
bend_of_the_river,8.4,5,5,0,100,0,0,0,0,0,0,0,0
car_wash,6.7,21,18,3,85,0,4,4,0,100,3.2,1578,59
come_september,6.1,5,4,1,80,0,0,0,0,0,0,0,0
destry_rides_again,7.7,16,16,0,100,0,0,0,0,0,0,0,0
electric_horseman,5.6,18,11,7,61,0,3,2,1,66,3.1,713,53
gay_purree,0,4,3,1,75,0,0,0,0,0,0,0,0
intervista_1984,6.9,11,8,3,72,0,3,2,1,66,3.6,467,68
king_rat,0,3,3,0,100,0,0,0,0,0,0,0,0
1040204-live_wire,2.4,5,0,5,0,0,0,0,0,0,0,0,0
mr_and_mrs_bridge,5.8,15,11,4,73,0,1,1,0,100,3.1,465,43
1017201-rare_breed,5.1,6,2,4,33,0,0,0,0,0,0,0,0
shenandoah,0,3,3,0,100,0,0,0,0,0,0,0,0
straight_talk,5.2,9,4,5,44,0,1,0,1,0,2.9,1027,51
1034151-oscar,3.4,15,2,13,13,0,1,0,1,0,2.8,3494,56
sixth_man,3.8,13,3,10,23,0,4,0,4,0,3,1793,54
1007101-far_country,7.8,10,10,0,100,0,0,0,0,0,0,0,0
1105025-railway_children,0,0,0,0,0,0,0,0,0,0,0,0,0
two_mules_for_sister_sara,6.3,8,6,2,75,0,1,0,1,0,3.5,3250,69
1023739-winchester_73,8.2,16,16,0,100,0,3,3,0,100,3.8,1273,84
ziggy_stardust_and_the_spiders_from_mars_the_motion_picture,6.1,28,20,8,71,6.2,8,5,3,62,3.6,27,60
battle_cry,0,3,3,0,100,0,0,0,0,0,0,0,0
courtship_of_eddies_father,0,4,2,2,50,0,0,0,0,0,0,0,0
chelovek-s-kino-apparatom-man-with-a-movie-camera,8.9,21,20,1,95,0,2,1,1,50,4.1,2142,88
objective_burma,0,2,1,1,50,0,0,0,0,0,0,0,0
operation_pacific,0,3,1,2,33,0,0,0,0,0,0,0,0
this_boys_life,6.3,34,26,8,76,5,10,4,6,40,3.5,5072,76
13_rue_madeleine,6.2,6,5,1,83,0,0,0,0,0,0,0,0
633_squadron,0,3,2,1,66,0,0,0,0,0,0,0,0
star_wars_episode_ii_attack_of_the_clones,6.5,215,142,73,66,5.5,40,16,24,40,3.3,108730,69
barton_fink,7.6,50,45,5,90,7.6,10,9,1,90,3.9,12267,88
battle_of_britain,5.5,8,5,3,62,0,1,0,1,0,3.8,2265,79
belle_epoque,7.5,15,14,1,93,0,3,3,0,100,3.6,1565,74
big_trail,6.8,7,7,0,100,0,0,0,0,0,0,0,0
1004370-cloak_and_dagger,5,5,2,3,40,0,0,0,0,0,0,0,0
comancheros,0,4,4,0,100,0,0,0,0,0,0,0,0
1006347-duel_at_diablo,0,3,3,0,100,0,0,0,0,0,0,0,0
flight_of_the_phoenix,4.8,115,34,81,29,4.4,27,5,22,18,3,7566,48
from_the_terrace,4.8,8,3,5,37,0,3,1,2,33,3.6,330,73
heaven_knows_mr_allison,7,7,6,1,85,0,0,0,0,0,0,0,0
hot_rock,6,8,5,3,62,0,1,0,1,0,3.4,651,61
1012662-long_hot_summer,7.2,15,13,2,86,0,4,2,2,50,3.8,1470,84
man_of_aran,7.6,15,14,1,93,0,3,3,0,100,3.6,320,72
1014451-music_box,6.4,14,9,5,64,0,1,0,1,0,0,0,0
north_to_alaska,4.7,6,2,4,33,0,0,0,0,0,0,0,0
this_man_must_die,7.9,6,6,0,100,0,1,1,0,100,3.7,342,78
sink_the_bismarck,0,4,3,1,75,0,0,0,0,0,0,0,0
blue_max,0,4,4,0,100,0,0,0,0,0,0,0,0
desert_fox,7,6,5,1,83,0,0,0,0,0,0,0,0
1022001-trial,7.4,25,22,3,88,7.3,5,4,1,80,4,1771,88
1041911-unforgiven,8.5,56,54,2,96,7.5,11,9,2,81,4,27203,91
1022315-undefeated,0,4,1,3,25,0,1,0,1,0,3.6,1146,72
divine-trash,6.9,5,4,1,80,0,1,1,0,100,3.7,350,77
good_burger,4.3,26,8,18,30,4.7,9,3,6,33,2.7,7419,60
jubilee,0,3,3,0,100,0,0,0,0,0,0,0,0
mississippi_masala,6.7,19,15,4,78,0,4,4,0,100,3.4,1551,64
jenny_lamour,8.3,30,30,0,100,8.3,11,11,0,100,3.9,498,87
stranger_among_us,4.8,13,4,9,30,0,2,0,2,0,2.7,1243,35
cahill_us_marshal,0,1,0,1,0,0,0,0,0,0,0,0,0
chisum,5.2,5,3,2,60,0,0,0,0,0,0,0,0
defense_of_the_realm,7.1,5,5,0,100,0,1,1,0,100,3.2,256,60
eat_a_bowl_of_tea,0,3,3,0,100,0,0,0,0,0,0,0,0
half_moon_street,5.5,5,3,2,60,0,1,1,0,100,2.8,382,29
1083373-truce,6.1,15,8,7,53,5.9,6,3,3,50,3.6,202,63
opportunity_knocks,4.5,8,2,6,25,0,1,0,1,0,2.9,523,45
shattered_glass,7.7,163,148,15,90,7.5,37,31,6,83,3.5,4409,76
song_of_bernadette,6.9,9,7,2,77,0,0,0,0,0,0,0,0
life_and_times_of_judge_roy_bean,5.8,7,5,2,71,0,1,0,1,0,3.4,951,66
thoroughly_modern_millie,7.6,9,9,0,100,0,0,0,0,0,0,0,0
1096832-where_the_heart_is,4.6,94,32,62,34,3.9,27,5,22,18,3.5,12595,78
dumb_and_dumberer_when_harry_met_lloyd,2.8,116,12,104,10,2.5,31,1,30,3,2.4,17380,37
from_justin_to_kelly,2.8,59,5,54,8,2.7,16,1,15,6,2,6715,39
hollywood_homicide,4.7,158,47,111,29,4.8,37,10,27,27,2.6,6121,32
rugrats_go_wild,5,83,33,50,39,4.9,28,12,16,42,2.9,2842,47
hard_word,5.5,82,33,49,40,5.5,26,10,16,38,3,615,45
heart_of_me,5.5,55,27,28,49,5.2,24,10,14,41,3.5,659,62
jet_lag,5.8,66,37,29,56,6.1,26,16,10,61,3.1,1234,49
loco_love,0,4,1,3,25,0,2,1,1,50,2.7,164,33
manito,7.3,31,29,2,93,7.8,14,14,0,100,3.5,124,65
best_of_the_best_3_no_turning_back,0,0,0,0,0,0,0,0,0,0,0,0,0
tycoon_a_new_russian,5.5,34,15,19,44,5.9,17,10,7,58,3.8,77,73
alex_and_emma,3.7,131,14,117,10,3.3,36,2,34,5,2.8,7767,42
on_line,4.6,39,15,24,38,3.7,17,2,15,11,2.3,8,0
experiment_in_terror,0,4,4,0,100,0,0,0,0,0,0,0,0
extasis_2008,0,0,0,0,0,0,0,0,0,0,0,0,0
is_paris_burning,6.4,5,4,1,80,0,0,0,0,0,0,0,0
murphys_war,0,2,0,2,0,0,1,0,1,0,3.4,129,58
orphans_of_the_storm,0,4,3,1,75,0,0,0,0,0,0,0,0
count-dracula-his-vampire-bride,0,0,0,0,0,0,0,0,0,0,0,0,0
28_days_later,7.3,200,177,23,88,7.1,39,34,5,87,3.6,107149,82
charlies_angels_full_throttle,5,171,74,97,43,5,37,15,22,40,3,33126,54
ed_and_his_dead_mother,5.4,6,3,3,50,0,0,0,0,0,0,0,0
fulltime_killer,6.2,32,18,14,56,5.8,10,5,5,50,3.7,2062,74
just_a_little_harmless_sex,4.4,5,1,4,20,0,0,0,0,0,0,0,0
1189844-the_bank_job,6.7,137,108,29,78,7.1,31,28,3,90,3.5,60915,74
fear_of_fear,9.2,16,16,0,100,0,2,2,0,100,4.1,1799,89
bodies_rest_and_motion,5,28,16,12,57,5.2,8,4,4,50,3,516,37
blood_of_jesus,0,1,1,0,100,0,0,0,0,0,0,0,0
long_ships,4.7,6,3,3,50,0,0,0,0,0,0,0,0
made_for_each_other,0,2,2,0,100,0,0,0,0,0,0,0,0
you_only_live_once,9,5,5,0,100,0,0,0,0,0,0,0,0
1079818-anastasia,7.1,48,41,7,85,7.1,9,7,2,77,3.2,33076,70
1065598-babe,8.2,54,53,1,98,8.2,11,11,0,100,3,22954,54
flight_of_the_intruder,4.3,11,3,8,27,0,2,0,2,0,3,858,50
fun_with_dick_and_jane,4.9,131,38,93,29,5.2,30,9,21,30,3.2,80127,58
1013089-main_event,4.9,8,3,5,37,0,1,0,1,0,3,481,44
mans_favorite_sport,6.2,15,9,6,60,0,3,1,2,33,3.5,622,71
mr_baseball,4.2,15,2,13,13,0,1,1,0,100,2.7,1578,36
1014832-never_on_sunday,6.8,7,6,1,85,0,0,0,0,0,0,0,0
mixed_nuts,2.8,28,2,26,7,2.5,6,0,6,0,2.9,2410,46
rhapsody-in-august,5.8,8,5,3,62,5.6,5,3,2,60,3.6,1375,73
1018316-scaramouche,0,3,1,2,33,0,0,0,0,0,0,0,0
start_the_revolution_without_me,6.6,5,4,1,80,0,0,0,0,0,0,0,0
strange_bedfellows,6.7,5,4,1,80,0,0,0,0,0,0,0,0
tenant,7.8,29,26,3,89,6.6,5,4,1,80,4,3556,87
advocate,5.6,8,6,2,75,0,2,2,0,100,3.3,530,54
up_the_sandbox,0,3,2,1,66,0,1,1,0,100,2.9,358,37
whats_up_doc,7.1,33,30,3,90,0,4,3,1,75,3.9,2794,87
the_incredible_hulk,6.1,210,138,72,65,5.7,38,21,17,55,3.6,124298,75
legally_blonde_2_red_white_and_blonde,4.8,147,55,92,37,5,36,14,22,38,2.9,41399,57
sinbad_legend_of_the_seven_seas,5.6,119,54,65,45,5.7,32,15,17,46,3.1,9338,57
terminator_3_rise_of_the_machines,6.6,195,137,58,70,6,38,22,16,57,3.2,42333,54
swimming_pool,7.1,148,125,23,84,6.9,37,33,4,89,3.3,5988,65
pirates_of_the_caribbean_the_curse_of_the_black_pearl,7.1,196,153,43,78,6.4,38,25,13,65,3.9,297546,86
madame_sata,6.2,42,25,17,59,6.7,15,11,4,73,3.7,461,75
league_of_extraordinary_gentlemen,4,174,30,144,17,3.9,37,5,32,13,3,42753,54
cuckoo,7,62,54,8,87,7.2,23,21,2,91,4,791,87
holy_land,5.8,54,28,26,51,5.8,19,10,9,52,3.6,173,68
1120788-housekeeper,6.5,60,46,14,76,7,22,20,2,90,3,76,35
i_capture_the_castle,6.7,81,65,16,80,6.4,27,19,8,70,3.7,1744,76
km0,5.6,44,24,20,54,5.6,16,8,8,50,3.6,424,72
northfork,5.9,99,56,43,56,5.6,32,16,16,50,3.5,992,68
bad_boys_ii,4.1,154,36,118,23,3.8,38,6,32,15,3.6,76903,80
how_to_deal,4.5,92,26,66,28,4.7,32,9,23,28,3.1,6783,64
johnny_english,4.8,115,38,77,33,5.2,30,13,17,43,2.9,21762,54
anarchist_cookbook,4.2,18,7,11,38,3.7,6,2,4,33,3.3,718,58
dirty_pretty_things,7.8,138,130,8,94,7.8,38,35,3,92,3.6,6668,79
1123900-embalmer,6.8,32,26,6,81,6.9,15,14,1,93,3.5,350,67
garage_days,5.1,52,23,29,44,4.7,17,6,11,35,3.3,1027,62
1125480-on_the_run,6.8,40,29,11,72,6.9,14,10,4,71,3.1,37,60
sea_is_watching,6.1,26,15,11,57,5.6,11,5,6,45,3.6,398,72
wild_hogs,3.8,139,20,119,14,3.4,34,3,31,8,3.4,86633,72
curly_sue,3.8,11,1,10,9,0,2,1,1,50,2.8,3986,49
little_giants,3.9,9,3,6,33,0,1,0,1,0,3.1,9092,62
loose_cannons,3,15,0,15,0,0,4,0,4,0,2.6,545,26
mouse_that_roared,7.1,18,16,2,88,0,0,0,0,0,0,0,0
spencers_mountain,0,3,3,0,100,0,0,0,0,0,0,0,0
masked_and_anonymous,4,77,19,58,24,3.4,28,3,25,10,3,954,46
lara_croft_tomb_raider_the_cradle_of_life,4.5,163,39,124,23,4.5,36,7,29,19,3.1,34884,60
seabiscuit-americas-legendary-racehorse,0,0,0,0,0,0,0,0,0,0,0,0,0
1127538-game_over,0,0,0,0,0,0,0,0,0,0,0,0,0
buffalo-soldiers,6.6,110,79,31,71,6.3,34,23,11,67,3.4,3099,70
camp,6,100,62,38,62,6.4,27,19,8,70,3.5,3093,70
1124189-hotel,4.5,25,9,16,36,4.6,11,4,7,36,2.6,446,34
lucia_lucia,5.4,48,21,27,43,5.6,20,7,13,35,3.4,312,57
mondays_in_the_sun,7,69,55,14,79,6.5,20,15,5,75,3.9,1360,86
scorched,4.6,6,1,5,16,0,1,1,0,100,3,906,43
avanti,6.9,16,13,3,81,0,3,1,2,33,3.6,906,72
1033042-eve_of_destruction,2.8,6,0,6,0,0,0,0,0,0,0,0,0
stoked_the_rise_and_fall_of_gator,6.6,47,37,10,78,6.6,19,15,4,78,3.8,199,78
1011319-juggernaut,0,3,2,1,66,0,0,0,0,0,0,0,0
kickboxer_2,0,1,1,0,100,0,0,0,0,0,0,0,0
kiss_me_stupid,6.4,20,15,5,75,6.4,6,5,1,83,3.4,784,66
1015567-one_two_three,7.7,17,16,1,94,0,4,4,0,100,4,1286,88
possible_loves,0,2,2,0,100,0,0,0,0,0,0,0,0
private_life_of_sherlock_holmes,7.6,21,20,1,95,7,5,4,1,80,3.5,1066,70
remo_williams_the_adventure_begins,4.6,12,6,6,50,0,0,0,0,0,0,0,0
the-blood-of-heroes1990,0,1,0,1,0,0,1,0,1,0,3.6,841,72
whats_up_tiger_lily,7,18,16,2,88,0,0,0,0,0,0,0,0
white_lightning,6.7,5,4,1,80,0,0,0,0,0,0,0,0
american_wedding,5.8,149,83,66,55,5.2,33,14,19,42,3.4,73646,72
straight-tripping,0,0,0,0,0,0,0,0,0,0,0,0,0
and_now_ladies_and_gentlemen,5.4,72,34,38,47,5.5,26,12,14,46,3.3,642,51
four-play,0,0,0,0,0,0,0,0,0,0,0,0,0
ill_be_there,5.2,6,3,3,50,0,1,1,0,100,3.3,685,59
magdalene_sisters,7.6,143,129,14,90,8.1,38,38,0,100,3.9,3422,87
secret_lives_of_dentists,7.2,93,79,14,84,7.3,33,29,4,87,3.2,653,54
freaky_friday,7,140,123,17,87,7,34,29,5,85,2.9,73112,60
swat,5.4,162,77,85,47,5.3,39,15,24,38,3.1,23455,63
1124832-divorce,5.2,133,49,84,36,5.7,37,16,21,43,2.5,3545,25
princess_blade,5.9,28,16,12,57,5.8,10,6,4,60,3.3,1979,55
step_into_liquid,6.9,77,63,14,81,7.1,28,26,2,92,4.1,1308,91
accattone,7.6,13,13,0,100,0,3,3,0,100,4.1,471,88
and_god_spoke,7,8,8,0,100,0,0,0,0,0,0,0,0
1109942-big_trouble,5.4,110,53,57,48,4.8,31,9,22,29,2.9,3337,52
double_life_of_veronique,7.6,25,21,4,84,7.6,5,5,0,100,4.3,5676,92
hawks_and_the_sparrows,6.5,10,8,2,80,0,3,3,0,100,4.1,399,84
man_in_the_glass_booth,0,3,3,0,100,0,1,1,0,100,4,91,88
red_pony,0,2,2,0,100,0,0,0,0,0,0,0,0
sex_and_the_other_man,0,0,0,0,0,0,0,0,0,0,0,0,0
gospel_according_to_st_matthew,8.4,27,25,2,92,0,4,4,0,100,4.1,1125,86
honeymoon_killers,8,18,17,1,94,0,3,3,0,100,3.5,670,67
umberto_d,8.9,25,24,1,96,8.9,7,7,0,100,4.3,1981,93
1116004-brothers_keeper,6,5,2,3,40,0,0,0,0,0,0,0,0
day_of_the_dolphin,5.4,17,9,8,52,0,3,0,3,0,3.1,307,43
i_love_you_to_death,5.6,17,10,7,58,0,2,1,1,50,3.3,2330,60
freddy_vs_jason,4.9,152,62,90,40,4.2,32,8,24,25,2.9,31156,60
1124859-grind,3.1,71,6,65,8,3,23,2,21,8,3.5,8588,79
open_range,6.8,170,134,36,78,6.7,33,23,10,69,3.5,8881,80
shaolin_soccer,7.1,87,79,8,90,7.4,28,28,0,100,3.7,17693,82
uptown_girls,3.8,108,14,94,12,3.9,30,5,25,16,3.1,32370,64
american_splendor,8.3,178,167,11,93,8.6,42,42,0,100,3.7,9157,85
1124952-carnage,6.9,36,28,8,77,7.1,11,9,2,81,3.7,239,71
passionada,5.6,45,26,19,57,5.8,16,9,7,56,3.2,457,55
agent_cody_banks,5.1,99,38,61,38,4.8,24,8,16,33,2.6,21724,41
camp_nowhere,3.6,10,1,9,10,0,2,1,1,50,2.8,2929,53
cemetery_club,5.8,7,4,3,57,0,3,2,1,66,2.9,263,36
changing_habits,0,2,0,2,0,0,0,0,0,0,0,0,0
hot_dog_the_movie,0,0,0,0,0,0,0,0,0,0,0,0,0
house_of_wax,4.3,148,37,111,25,4.5,30,6,24,20,2.8,39495,54
inn_of_the_sixth_happiness,0,2,2,0,100,0,0,0,0,0,0,0,0
prince-of-jutland-royal-deceit,0,0,0,0,0,0,0,0,0,0,0,0,0
rowing_with_the_wind,0,1,0,1,0,0,0,0,0,0,0,0,0
rachel_papers,0,2,1,1,50,0,0,0,0,0,0,0,0
sure_thing,6.8,26,23,3,88,6.8,5,4,1,80,3.5,2781,75
thrashin,0,0,0,0,0,0,0,0,0,0,0,0,0
virginias_run,0,2,1,1,50,0,2,1,1,50,3.7,550,73
wait_until_dark,7.8,17,16,1,94,0,0,0,0,0,0,0,0
code_unknown,6.9,37,26,11,70,7.2,9,7,2,77,3.8,1347,78
showdown_in_little_tokyo,4.3,6,2,4,33,0,0,0,0,0,0,0,0
tokyo_story,9.6,34,34,0,100,0,3,3,0,100,4.4,3458,94
1020432-summer,7.7,12,11,1,91,0,3,3,0,100,4.1,525,84
thx_1138,7,56,50,6,89,6.9,10,9,1,90,3.6,7990,73
beyond_the_valley_of_the_dolls,6.1,22,15,7,68,0,3,1,2,33,0,0,0
business_of_fancydancing,5.7,30,17,13,56,5.2,8,4,4,50,3.6,262,70
chunhyang,7,40,34,6,85,7.5,11,11,0,100,3.6,318,71
tunes_of_glory,5.7,6,4,2,66,0,0,0,0,0,0,0,0
kind_hearts_and_coronets,8.8,26,26,0,100,0,4,4,0,100,4.3,2828,93
1119133-ash_wednesday,4,14,4,10,28,0,4,1,3,25,3.1,670,46
joe_kidd,6.8,6,5,1,83,0,1,0,1,0,3.2,1890,50
keep,4.1,9,1,8,11,0,0,0,0,0,0,0,0
atragon_1965,0,0,0,0,0,0,0,0,0,0,0,0,0
mysterians,0,4,3,1,75,0,0,0,0,0,0,0,0
attack_of_the_puppet_people,0,1,0,1,0,0,0,0,0,0,0,0,0
beast_from_20000_fathoms,6.8,10,9,1,90,0,0,0,0,0,0,0,0
enchanted,7.3,157,145,12,92,7.4,34,31,3,91,3.8,188655,80
tremors,7,24,21,3,87,0,1,1,0,100,3,16973,63
1017346-red_shoes,9.1,41,40,1,97,8.2,6,6,0,100,4.2,2989,89
me_and_isaac_newton,7,9,8,1,88,0,2,2,0,100,3.2,135,40
pink_panther,4.1,139,31,108,22,4.1,32,6,26,18,3,52976,59
pink_panther_strikes_again,7.1,17,14,3,82,0,1,0,1,0,3.4,5835,80
1004567-commando,6,31,22,9,70,0,3,2,1,66,3.1,18349,65
1006234-dracula,7.7,42,39,3,92,7.7,6,6,0,100,3.6,8598,76
discreet_charm_of_the_bourgeoisie,8.4,38,37,1,97,7.6,10,10,0,100,4.2,3780,90
waco_the_rules_of_engagement,7.8,16,14,2,87,0,3,2,1,66,3.8,380,82
1108624-road_home,7.4,79,70,9,88,7.6,23,21,2,91,4.1,2770,88
ikiru,8.6,30,30,0,100,8.3,9,9,0,100,4.5,5818,96
comic_book_villains,0,4,3,1,75,0,0,0,0,0,0,0,0
angel_at_my_table,7.6,13,12,1,92,0,2,2,0,100,4,986,87
war_photographer,6.9,25,20,5,80,7,9,7,2,77,4.3,673,91
ay_carmela,0,2,1,1,50,0,0,0,0,0,0,0,0
war-and-peace-jang-aur-aman,0,0,0,0,0,0,0,0,0,0,0,0,0
loin,0,1,1,0,100,0,0,0,0,0,0,0,0
incident-at-oglala,7.7,12,12,0,100,0,1,1,0,100,4.1,260,85
handmaids_tale,4.6,12,3,9,25,0,2,0,2,0,3,1026,44
revolution-os,5.8,14,6,8,42,0,3,0,3,0,3.7,350,74
live_nude_girls_unite,7.1,17,14,3,82,0,4,4,0,100,3.8,355,63
all_the_little_animals,5.4,21,13,8,61,5.3,6,4,2,66,3.8,1085,76
1197228-earth,7.2,88,76,12,86,7.1,23,20,3,86,3.8,80150,74
man_on_fire,5.2,157,61,96,38,5.1,38,14,24,36,3.9,67139,89
1005512-death_in_venice,7.1,15,11,4,73,0,2,0,2,0,4,1986,83
marci_x,2.9,52,5,47,9,3.3,14,2,12,14,2.3,826,28
medallion,3.9,122,22,100,18,4.3,32,9,23,28,2.7,7847,42
my_bosss_daughter,2.4,66,6,60,9,2.6,15,2,13,13,2.5,6043,32
autumn_spring,7.3,37,36,1,97,7,13,12,1,92,3.7,349,81
battle_of_shaker_heights,5.1,57,24,33,42,4.4,23,5,18,21,3.2,1504,52
dont_tempt_me,5.1,29,11,18,37,5.2,9,4,5,44,3.5,1529,66
ask_the_dust,5.1,103,37,66,35,5.5,32,16,16,50,2.8,14077,37
stoked_the_rise_and_fall_of_gator,6.6,47,37,10,78,6.6,19,15,4,78,3.8,199,78
venus-boyz,6.1,16,13,3,81,5.9,6,5,1,83,3.4,203,70
1125073-suddenly,6.6,21,20,1,95,6.9,8,8,0,100,3.1,56,22
jeepers_creepers_2,4.2,119,26,93,21,3.9,26,4,22,15,2.8,17496,53
bollywoodhollywood,5,45,18,27,40,4.6,15,4,11,26,3.2,1101,57
civil_brand,3.8,19,3,16,15,3.9,9,2,7,22,3.8,954,73
nola,3.1,13,0,13,0,2.9,8,0,8,0,3.1,258,38
once_upon_a_time_in_the_midlands,5.7,74,38,36,51,5.9,25,16,9,64,3.1,886,45
other_side_of_the_bed,5,41,19,22,46,5,16,8,8,50,3.5,1042,66
1177706-day_zero,4.1,19,4,15,21,4,7,0,7,0,3.1,1008,45
dickie_roberts_former_child_star,4.5,114,26,88,22,4.5,32,7,25,21,2.8,8342,52
home_room,5.5,21,11,10,52,4.6,9,2,7,22,3.7,861,79
party_monster,4.4,75,20,55,26,4,28,5,23,17,3.5,6775,77
sides,0,0,0,0,0,0,0,0,0,0,0,0,0
1125409-cabin_fever,5.9,134,84,50,62,5.2,31,15,16,48,2.6,15690,45
matchstick_men,7.1,180,148,32,82,6.6,38,29,9,76,3.3,14261,76
once_upon_a_time_in_mexico,6.3,159,108,51,67,6.3,33,22,11,66,3.2,31247,66
1125540-dummy,6.2,32,23,9,71,5.8,10,7,3,70,3.6,2069,74
lost_in_translation,8.4,215,203,12,94,8.5,41,40,1,97,3.6,84187,84
luster,4.6,10,5,5,50,0,3,1,2,33,2.9,329,40
millennium-actress,7.6,49,45,4,91,7.7,13,12,1,92,4.1,4498,87
so_close,6.7,37,30,7,81,6,9,5,4,55,3.9,2855,80
children_of_the_night,0,1,0,1,0,0,0,0,0,0,0,0,0
daisy_miller,6,5,4,1,80,0,0,0,0,0,0,0,0
enlightenment-guaranteed,6.6,13,8,5,61,0,3,2,1,66,3.9,316,88
gotcha,4.8,9,4,5,44,0,1,0,1,0,3,845,47
hard_to_hold,0,1,0,1,0,0,0,0,0,0,0,0,0
kuffs,4.5,15,4,11,26,0,1,0,1,0,2.9,2235,46
once_upon_a_time_in_china,7.3,25,22,3,88,0,2,2,0,100,3.8,4888,85
once_upon_a_time_in_china_2,6.9,14,13,1,92,0,3,2,1,66,3.8,3504,82
once_upon_a_time_in_china_3,6,8,5,3,62,0,0,0,0,0,0,0,0
paper_moon,8.4,29,26,3,89,8,6,4,2,66,4,3053,91
sgt-peppers-lonely-hearts-club-band,2.9,20,3,17,15,0,3,0,3,0,2.9,1491,52
song_for_martin,7.3,27,23,4,85,7,12,9,3,75,3.5,333,70
targets,7.5,24,21,3,87,6.4,5,3,2,60,3.7,829,78
ugly_american,6.1,5,4,1,80,0,0,0,0,0,0,0,0
bostonians,6.2,5,3,2,60,0,1,1,0,100,2.9,265,32
1004703-convoy,4.1,8,4,4,50,0,1,0,1,0,3.6,2494,73
1009483-hello_dolly,5.9,16,8,8,50,0,0,0,0,0,0,0,0
im_going_home,7.7,52,50,2,96,8.2,19,19,0,100,3.4,322,63
memoirs_of_an_invisible_man,4.6,25,6,19,24,0,2,0,2,0,2.6,2632,30
stalags,5.8,12,6,6,50,0,4,1,3,25,3.8,33,80
1158185-see_no_evil,2.6,57,5,52,8,2.5,14,1,13,7,3.3,46137,61
super_sucker,4.1,14,4,10,28,0,4,1,3,25,2.9,303,42
indiscretion_of_an_american_wife,6.2,6,4,2,66,0,0,0,0,0,0,0,0
at_war_with_the_army,0,2,0,2,0,0,0,0,0,0,0,0,0
1036537-bingo,0,1,0,1,0,0,1,0,1,0,2.7,1322,36
god_told_me_to,6.1,7,5,2,71,0,1,0,1,0,3.3,590,57
i_madman,0,4,3,1,75,0,1,1,0,100,3,387,44
1031385-jungle_book,7.3,27,24,3,88,0,2,1,1,50,3.5,35715,70
once_bitten,3.4,10,1,9,10,0,0,0,0,0,0,0,0
camaron-en-eo-asador,0,0,0,0,0,0,0,0,0,0,0,0,0
squirm,4.3,10,3,7,30,0,0,0,0,0,0,0,0
adventures_of_huck_finn,5.9,13,8,5,61,0,4,3,1,75,2.9,2408,47
brood,7,14,11,3,78,0,1,0,1,0,3.5,2752,65
the-prince-and-the-pauper-1990,0,0,0,0,0,0,0,0,0,0,0,0,0
anything_else,5.2,130,53,77,40,5,35,12,23,34,2.9,4837,45
cold_creek_manor,3.8,108,13,95,12,4.5,27,6,21,22,2.6,4032,31
fighting_temptations,5.4,105,44,61,41,5.8,30,17,13,56,3.2,5134,69
secondhand_lions,6.1,132,78,54,59,5.2,31,11,20,35,3.7,13936,83
underworld,4.7,155,47,108,30,4.4,32,5,27,15,3.6,101467,82
bubba_hotep,6.8,102,80,22,78,6,27,19,8,70,3.6,14170,78
casa_de_los_babys,6,105,61,44,58,5.8,29,16,13,55,3.2,515,50
demonlover,5.5,75,36,39,48,6,21,14,7,66,2.9,692,43
close-your-eyes,5.7,36,17,19,47,5.2,13,7,6,53,3,925,39
where_in_the_world_is_osama_bin_laden,4.9,102,38,64,37,4.6,29,9,20,31,3.3,2558,55
tibet_cry_of_the_snow_lion,7.4,49,42,7,85,7.6,20,18,2,90,4,721,82
yossi_and_jagger,6.8,41,36,5,87,7.2,15,14,1,93,3.7,822,74
duplex,5,104,38,66,36,4.8,28,9,19,32,2.9,11260,46
rundown,6.4,143,102,41,71,6.1,31,20,11,64,3.3,18070,72
under_the_tuscan_sun,6.2,143,87,56,60,6.3,35,21,14,60,3.4,14219,77
camera_obscura,5,7,3,4,42,0,1,0,1,0,3,37,50
1125461-luther,5.2,61,27,34,44,5,21,9,12,42,3.7,2529,76
mambo_italiano,4.7,72,23,49,31,5,23,8,15,34,3.3,1531,64
love-my-life,0,0,0,0,0,0,0,0,0,0,0,0,0
national-lampoons-dorm-daze-2,0,0,0,0,0,0,0,0,0,0,0,0,0
to_be_and_to_have,8.1,58,56,2,96,8.1,21,20,1,95,4.1,1542,89
acid-drinkers-15-screwed-years2004,0,0,0,0,0,0,0,0,0,0,0,0,0
videodrome,7.1,44,35,9,79,0,3,3,0,100,3.6,9415,79
life_and_debt,7.3,42,38,4,90,7.6,12,12,0,100,4.1,552,90
lagaan,7.9,59,56,3,94,7.9,19,19,0,100,4.2,4800,90
judgment_at_nuremburg,7.7,19,17,2,89,0,2,1,1,50,4,2099,90
1036156-journey_of_hope,6.4,5,4,1,80,0,2,1,1,50,4.2,163,87
same_time_next_year,4.5,5,2,3,40,0,0,0,0,0,0,0,0
brief_history_of_time,7.3,12,11,1,91,0,2,1,1,50,3.9,305,86
jacob_the_liar,6.3,5,5,0,100,0,0,0,0,0,0,0,0
leningrad_cowboys_go_america,7.5,5,5,0,100,0,0,0,0,0,0,0,0
1017971-rules_of_the_game,9.1,37,36,1,97,9,10,10,0,100,4.3,2952,91
song_remains_the_same,6.6,11,8,3,72,0,0,0,0,0,0,0,0
seven_brides_for_seven_brothers,7.5,18,15,3,83,0,0,0,0,0,0,0,0
kiss_of_the_spider_woman,7.5,24,21,3,87,0,3,3,0,100,3.6,2040,78
all_the_presidents_men,9,40,40,0,100,0,3,3,0,100,3.9,11562,89
angie,5.2,15,6,9,40,0,3,1,2,33,2.7,642,31
appartement,0,2,2,0,100,0,0,0,0,0,0,0,0
mists_of_avalon,5.6,7,3,4,42,0,1,1,0,100,3.7,4639,74
babettes_feast,8.6,14,13,1,92,0,1,0,1,0,4.2,3211,90
barber_of_siberia,0,3,0,3,0,0,0,0,0,0,0,0,0
1038726-beethoven,4.8,23,7,16,30,6.1,5,4,1,80,2.8,16534,41
beethovens_2nd,4.4,10,2,8,20,0,2,0,2,0,2.6,7881,35
black_moon_rising,3.9,9,3,6,33,0,2,1,1,50,2.8,1020,32
boyz_n_the_hood,8.3,45,44,1,97,7.7,9,9,0,100,3.7,22104,88
bugsy,7,32,29,3,90,0,2,2,0,100,3.2,1987,62
bugsy_malone,6.4,16,12,4,75,0,1,1,0,100,3.5,3796,76
by_the_sword,0,2,0,2,0,0,1,0,1,0,3.6,301,69
1004407-cobra,2.5,14,1,13,7,0,3,1,2,33,2.7,5821,43
comunidad,0,3,3,0,100,0,0,0,0,0,0,0,0
1040755-consenting_adults,4.2,10,3,7,30,0,1,0,1,0,2.8,822,29
phenomenon,5.9,32,16,16,50,5.5,6,1,5,16,3,9166,62
crying_freeman,0,1,1,0,100,0,0,0,0,0,0,0,0
1108520-1108520-time_and_tide,6.1,43,27,16,62,6.4,15,10,5,66,3.6,915,71
monty_pythons_the_meaning_of_life,7.5,26,23,3,88,0,0,0,0,0,0,0,0
where_eagles_dare,6.5,17,15,2,88,0,3,2,1,66,3.8,5588,85
tightrope,6.8,11,9,2,81,0,1,1,0,100,3.1,1687,46
sleeping_with_the_enemy,4.4,31,7,24,22,3.8,7,1,6,14,3.2,11187,67
pcu,5.2,15,7,8,46,0,2,0,2,0,3.5,3192,73
1112954-rookie,7.2,140,115,25,82,7.4,32,29,3,90,3.3,10597,68
ghost_and_mr_chicken,6.2,6,4,2,66,0,0,0,0,0,0,0,0
city_heat,3.8,13,3,10,23,0,4,1,3,25,2.8,1089,30
30_days_of_night,5.5,150,73,77,48,5.1,28,13,15,46,3.3,146766,57
three_oclock_high,5.6,8,5,3,62,0,1,0,1,0,3.4,1098,70
white_hunter_black_heart,7,32,28,4,87,6.6,8,6,2,75,3.2,1489,54
1036052-come_and_see,8,20,19,1,95,0,4,3,1,75,4.5,2288,96
rage_in_harlem,6.7,11,9,2,81,0,2,1,1,50,3.2,878,54
ginger_snaps,7.4,46,41,5,89,7.1,8,7,1,87,3.4,8664,76
more_american_graffiti,4.2,9,2,7,22,0,0,0,0,0,0,0,0
ballad_of_little_jo,5.8,8,6,2,75,0,2,2,0,100,3.1,555,50
1100197-under_suspicion,5.3,44,22,22,50,5.2,12,6,6,50,3.2,1858,49
taistoi,0,1,1,0,100,0,0,0,0,0,0,0,0
reluctant_astronaut,0,0,0,0,0,0,0,0,0,0,0,0,0
shakiest_gun_in_the_west,0,0,0,0,0,0,0,0,0,0,0,0,0
sunday_in_the_country,8.4,6,6,0,100,0,1,1,0,100,3.5,302,71
gun_in_betty_lous_handbag,3.6,11,1,10,9,0,0,0,0,0,0,0,0
sudden_fear,6.8,5,5,0,100,0,0,0,0,0,0,0,0
nobodys_baby,4,5,0,5,0,0,0,0,0,0,0,0,0
regarding_henry,5.1,25,12,13,48,0,2,0,2,0,3.3,3801,64
the-debut2000,0,0,0,0,0,0,0,0,0,0,0,0,0
wilder_napalm,3.6,7,2,5,28,0,1,0,1,0,3,367,42
contamination,0,2,0,2,0,0,0,0,0,0,0,0,0
amazing_transparent_man,5,5,2,3,40,0,0,0,0,0,0,0,0
1056341-love_affair,4.8,26,8,18,30,0,3,1,2,33,3.5,1260,71
all_i_want,3.5,7,0,7,0,0,0,0,0,0,0,0,0
article_99,5.4,12,6,6,50,0,2,0,2,0,3.2,709,53
picture_this,0,0,0,0,0,0,0,0,0,0,0,0,0
oleanna,5.8,16,9,7,56,0,2,1,1,50,3.3,398,59
chattahoochee,4.9,5,1,4,20,0,2,0,2,0,3.3,468,54
tough_guys_dont_dance,4.9,18,7,11,38,0,4,2,2,50,3.3,251,49
there_goes_my_baby,0,1,0,1,0,0,0,0,0,0,0,0,0
kingdom_of_the_spiders,5.5,9,4,5,44,0,0,0,0,0,0,0,0
1018413-scrooge,6.8,16,11,5,68,0,3,2,1,66,3.4,1834,72
1042059-leap_of_faith,5.8,18,12,6,66,0,1,1,0,100,2.7,1901,38
gas_food_lodging,6.5,13,10,3,76,0,2,2,0,100,3.5,533,73
1010448-in_cold_blood,8.3,25,22,3,88,7.8,5,4,1,80,3.8,2614,83
campus_man,0,0,0,0,0,0,0,0,0,0,0,0,0
bedford_incident,6.9,7,7,0,100,0,0,0,0,0,0,0,0
murderous_maids,7.3,47,43,4,91,7.8,13,13,0,100,3.7,64,74
yankee_doodle_dandy,7.9,23,21,2,91,0,3,3,0,100,3.8,1924,83
ninja-scroll,8.3,5,5,0,100,0,0,0,0,0,0,0,0
knife_in_the_water,8.2,30,30,0,100,0,4,4,0,100,3.9,2383,85
devil_and_daniel_webster,7.9,16,16,0,100,0,0,0,0,0,0,0,0
mobsters,3.8,11,1,10,9,0,2,0,2,0,3.1,2921,54
charlotte_sometimes,6.8,44,36,8,81,7.6,11,11,0,100,3.5,200,66
time-to-pay,0,0,0,0,0,0,0,0,0,0,0,0,0
school_of_rock,7.8,188,172,16,91,8.2,39,38,1,97,3.2,183700,63
concert_for_george,7.6,18,17,1,94,7.3,9,8,1,88,4.3,31,90
lemony_snicket,6.6,154,109,45,70,6.6,32,19,13,59,3.2,60437,61
nine_dead_gay_guys,4,23,5,18,21,2.6,9,1,8,11,3.4,768,61
station_agent,8,149,142,7,95,8,33,33,0,100,3.9,7193,90
wonderland,5,98,34,64,34,4.5,32,7,25,21,3.3,3666,67
bus_174,8.3,73,73,0,100,8.1,22,22,0,100,3.9,1380,87
mystic_river,7.8,193,168,25,87,8,40,38,2,95,3.7,30024,86
1126165-good_boy,5.3,84,37,47,44,5.6,26,15,11,57,3,2701,49
1126175-house_of_the_dead,1.9,53,2,51,3,2,12,1,11,8,1.9,6777,20
intolerable_cruelty,6.7,178,133,45,74,6.8,41,31,10,75,2.9,12106,43
kill_bill_vol_2,7.7,226,193,33,85,7.7,43,35,8,81,3.8,162324,87
dopamine,5.5,51,26,25,50,5.4,20,8,12,40,3.1,357,51
flower_of_evil,6.2,60,39,21,65,6.8,20,15,5,75,3.1,468,43
girls_will_be_girls,5.6,31,18,13,58,5,13,6,7,46,3.6,1305,71
runaway_jury,6.6,152,111,41,73,6.6,38,28,10,73,3.4,11578,73
texas_chainsaw_massacre,4.8,152,55,97,36,4.2,33,6,27,18,3.2,36030,67
pieces_of_april,7.1,145,122,23,84,7.2,36,31,5,86,3.3,5487,68
return,3.9,55,8,47,14,3.9,15,2,13,13,2.9,26258,38
1126413-sylvia,5.3,126,46,80,36,5.2,34,9,25,26,3.3,2530,58
veronica_guerin,6,135,73,62,54,5.5,35,15,20,42,3.6,2866,72
in_the_cut,4.8,144,48,96,33,5,37,11,26,29,2.7,3073,36
beyond_borders,4.3,101,14,87,13,4.2,34,4,30,11,3.5,6426,75
radio,5,115,41,74,35,4.9,32,8,24,25,3.6,23763,83
scary_movie_3,4.8,124,45,79,36,4.8,30,11,19,36,3,92592,68
brother_bear,5.5,122,46,76,37,5.3,30,10,20,33,3.3,23328,68
elephant,7,142,100,42,70,7.1,35,27,8,77,3.6,15005,79
gypsy_83,5.5,26,14,12,53,5.2,12,6,6,50,3.9,728,77
singing_detective,5.1,106,41,65,38,5,28,9,19,32,3,2164,42
italian_job,6.4,178,129,49,72,6.7,40,32,8,80,3.6,103062,79
impulse,0,2,0,2,0,0,0,0,0,0,0,0,0
normal,7.2,6,6,0,100,0,2,2,0,100,3.6,624,71
shoah,8.8,12,12,0,100,0,1,1,0,100,4.6,400,96
1124362-unconditional_love,3.7,6,1,5,16,0,1,0,1,0,3.5,739,65
super-sweet-16-the-movie,0,1,0,1,0,0,0,0,0,0,0,0,0
alien-from-la-odeon-wanda,1.3,6,0,6,0,0,0,0,0,0,0,0,0
1002526-black_sunday,7.4,11,11,0,100,0,0,0,0,0,0,0,0
men_of_respect,0,3,0,3,0,0,1,0,1,0,3.1,107,47
interstate_60,6.4,5,4,1,80,0,0,0,0,0,0,0,0
lipstick,4.4,5,1,4,20,0,1,0,1,0,3,279,43
storyville,6,5,3,2,60,0,1,1,0,100,2.7,221,23
that-was-then-this-is-now,3.2,5,0,5,0,0,0,0,0,0,0,0,0
holy-matrimony1943,0,0,0,0,0,0,0,0,0,0,0,0,0
legend_of_the_black_scorpion,4.4,8,3,5,37,0,2,0,2,0,3.5,2288,62
eye,6.1,102,65,37,63,6.3,30,21,9,70,3.5,8843,71
kronos,5,6,4,2,66,0,0,0,0,0,0,0,0
jolson_story,0,4,4,0,100,0,0,0,0,0,0,0,0
youll_never_get_rich,0,2,1,1,50,0,0,0,0,0,0,0,0
frankenstein-and-the-monster-from-hell,0,0,0,0,0,0,0,0,0,0,0,0,0
preaching_to_the_perverted,0,4,2,2,50,0,0,0,0,0,0,0,0
chicago_joe_and_the_showgirl,0,4,1,3,25,0,1,0,1,0,2.9,170,31
quest_for_camelot,5.3,21,7,14,33,5.9,6,2,4,33,3.1,4042,62
aparajito,8.4,14,13,1,92,8.2,7,6,1,85,4.3,811,92
hired_hand,7.4,11,10,1,90,0,3,2,1,66,3.4,491,67
le_cercle_rouge,8.3,57,54,3,94,8.5,19,19,0,100,4.2,1875,92
man_of_marble,0,2,2,0,100,0,0,0,0,0,0,0,0
sherlock_holmes_and_the_voice_of_terror,0,3,2,1,66,0,0,0,0,0,0,0,0
sherlock_holmes_faces_death,0,2,2,0,100,0,0,0,0,0,0,0,0
sherlock_holmes_in_washington,0,2,2,0,100,0,0,0,0,0,0,0,0
solid_gold_cadillac,7.5,5,5,0,100,0,0,0,0,0,0,0,0
human_stain,5.5,147,62,85,42,5.6,38,15,23,39,3.1,3875,50
die_mommie_die,6,59,38,21,64,6.5,21,16,5,76,3.5,839,67
joe_dirt,3,74,8,66,10,2.7,24,1,23,4,2.8,16165,63
girlhood,7.7,33,31,2,93,7.5,11,10,1,90,3.5,176,65
mail_order_wife,6,32,20,12,62,6.2,9,6,3,66,3.5,426,68
shattered_glass,7.7,163,148,15,90,7.5,37,31,6,83,3.5,4409,76
matrix_revolutions,5.3,203,74,129,36,5,37,10,27,27,3.4,111917,70
revolution_will_not_be_televised,7.9,48,47,1,97,7.9,20,20,0,100,4.2,655,90
elf,6.9,166,139,27,83,6.5,38,29,9,76,3.2,66072,73
anything-but-love,0,0,0,0,0,0,0,0,0,0,0,0,0
billabong_odyssey,4.9,11,4,7,36,4,5,1,4,20,4.1,417,88
gloomy_sunday,7,64,54,10,84,6.8,16,13,3,81,4.1,1350,91
in-my-skin,6,41,26,15,63,5.5,12,7,5,58,3.6,899,68
love_actually,6.4,187,118,69,63,6.3,42,25,17,59,3.1,191514,71
1037864-father_of_the_bride,5.8,29,21,8,72,0,2,2,0,100,3.2,22336,67
my-architect,7.5,90,84,6,93,7.7,26,26,0,100,3.8,825,81
looney_tunes_back_in_action,6,130,73,57,56,5.9,32,20,12,62,2.7,8974,43
master_and_commander_the_far_side_of_the_world,7.6,205,174,31,84,7.8,41,38,3,92,3.3,17643,75
tupac_resurrection,6.7,85,66,19,77,6.6,32,26,6,81,4,2964,87
1127652-big_empty,5.3,7,5,2,71,0,1,1,0,100,3.1,888,48
1127407-missing,6.1,168,98,70,58,6.1,39,21,18,53,3,6895,52
cat_in_the_hat,3.2,148,16,132,10,3.4,37,5,32,13,2.5,15383,41
gothika,4.1,161,24,137,14,3.9,34,2,32,5,3,23666,56
21_grams,7.5,175,142,33,81,8.1,36,32,4,88,3.6,38037,83
barbarian_invasions,7.2,125,103,22,82,7.3,35,29,6,82,3.9,4434,88
1188215-blindness,5.2,150,63,87,42,5,30,8,22,26,3.1,17761,49
blue-gate-crossing,7.1,12,10,2,83,6.8,6,5,1,83,3.9,931,86
bad_santa,6.7,187,144,43,77,6.9,40,32,8,80,3.2,17921,73
haunted_mansion,4.2,134,18,116,13,4.4,31,6,25,19,2.6,14063,41
timeline,3.7,135,15,120,11,3.8,33,5,28,15,2.9,8959,52
marquis-de-sade-justine,0,1,0,1,0,0,0,0,0,0,0,0,0
damage,6.7,19,14,5,73,0,3,2,1,66,0,0,0
1124927-ot_our_town,7,24,21,3,87,6.9,6,5,1,83,3.6,67,82
the-devils-playground,0,0,0,0,0,0,0,0,0,0,0,0,0
dance_with_a_stranger,7.4,10,9,1,90,0,1,1,0,100,3.4,510,64
journeys_with_george,6.6,10,8,2,80,0,3,2,1,66,3.4,435,71
darkman,6.6,46,36,10,78,7.1,8,7,1,87,2.9,9871,50
dead-of-night-mirror-of-death,0,0,0,0,0,0,0,0,0,0,0,0,0
death_by_design,0,1,1,0,100,0,0,0,0,0,0,0,0
le_dernier_combat,0,3,2,1,66,0,0,0,0,0,0,0,0
desk_set,6.8,16,16,0,100,0,2,2,0,100,3.9,1337,81
zentropa,7.2,12,10,2,83,0,1,1,0,100,4,2055,88
watermelon_woman,7.3,5,5,0,100,0,1,1,0,100,3.2,237,54
final_analysis,5.3,22,11,11,50,5.8,6,3,3,50,2.8,1422,37
10009001-the_freshman,7.3,32,30,2,93,7.2,8,7,1,87,3.1,2525,52
1175174-funny_games,5.6,138,71,67,51,4.7,34,13,21,38,3.2,16153,54
tales_from_the_crypt,0,1,1,0,100,0,0,0,0,0,0,0,0
new_jack_city,6.4,28,22,6,78,7.2,7,6,1,85,0,0,0
slackers,3.1,104,11,93,10,2.4,30,1,29,3,2.8,4294,52
wargames,7.4,27,26,1,96,0,4,3,1,75,3.3,7636,68
mr_hobbs_takes_a_vacation,5.8,9,8,1,88,0,0,0,0,0,0,0,0
ordet,9.4,11,11,0,100,0,1,1,0,100,4.4,1138,91
1007681-forbidden_games,8.8,9,9,0,100,0,0,0,0,0,0,0,0
1020815-tale_of_two_cities,0,0,0,0,0,0,0,0,0,0,0,0,0
passion_of_joan_of_arc,8.9,31,30,1,96,8.1,6,5,1,83,4.4,3362,94
benhur,7.8,33,30,3,90,0,4,3,1,75,3.7,25817,80
1003361-cabinet_of_dr_caligari,8.9,34,34,0,100,0,1,1,0,100,4.1,6812,88
gorky_park,6.6,22,17,5,77,0,4,3,1,75,3.3,824,57
the-great-train-robbery1903,7.6,6,6,0,100,0,0,0,0,0,0,0,0
greystoke_the_legend_of_tarzan_lord_of_the_apes,5.8,10,6,4,60,0,0,0,0,0,0,0,0
guarding_tess,5.6,31,18,13,58,6.7,7,5,2,71,3,2875,51
hannah_and_her_sisters,8.4,40,37,3,92,8.5,5,5,0,100,3.9,7548,88
hard_way,5.8,18,14,4,77,0,2,1,1,50,3,2056,46
hercules_in_new_york,2.8,5,1,4,20,0,0,0,0,0,0,0,0
highlander_2_the_quickening,2.6,21,0,21,0,0,3,0,3,0,2.6,7551,37
hoffa,5.6,20,11,9,55,0,2,1,1,50,3.3,2678,58
housesitter,5.1,17,7,10,41,0,2,1,1,50,2.7,3753,46
hudson_hawk,3.6,30,6,24,20,0,4,1,3,25,2.9,6827,54
1010678-invasion_of_the_body_snatchers,8.9,36,36,0,100,0,2,2,0,100,3.6,3820,81
mind_walk,6.6,8,7,1,87,0,0,0,0,0,0,0,0
kafka-1992,0,0,0,0,0,0,0,0,0,0,0,0,0
kindergarten_cop,5.1,32,16,16,50,5.7,6,3,3,50,3,22205,53
king_ralph,4.7,9,2,7,22,0,1,0,1,0,2.4,1885,26
knight_moves,3.7,5,1,4,20,0,1,0,1,0,2.9,884,37
last_boy_scout,5.1,30,13,17,43,0,4,2,2,50,3.3,11177,66
last_tango_in_paris,7.8,26,21,5,80,0,4,3,1,75,3.6,6478,76
lorenzos_oil,6.8,23,22,1,95,0,3,3,0,100,3.5,2829,76
lover,4.8,15,4,11,26,0,4,0,4,0,3.8,2726,80
10009680-matador,6.7,14,11,3,78,6.7,5,4,1,80,3.4,113,56
mr_destiny,4.7,15,6,9,40,0,2,0,2,0,3,1673,47
night_of_the_hunter,8.7,41,40,1,97,8,8,7,1,87,4.2,5852,91
1042212-nowhere_to_run,3.9,19,5,14,26,3,6,0,6,0,2.7,2820,39
only_the_lonely,5.9,18,11,7,61,0,1,0,1,0,2.9,1292,45
passenger_57,3.9,21,5,16,23,0,1,0,1,0,2.9,8383,48
presumed_innocent,7.2,31,29,2,93,7.5,8,8,0,100,3.2,3836,60
1016832-project_x,6.2,9,7,2,77,0,1,1,0,100,3.1,1570,53
proof,6.4,138,87,51,63,6.4,34,20,14,58,3.2,15629,57
pure_luck,4,9,1,8,11,0,2,0,2,0,0,0,0
1217514-battle_royale,7.2,22,18,4,81,0,0,0,0,0,0,0,0
wedding_banquet,7.5,16,15,1,93,0,2,2,0,100,3.9,2178,86
salo,6.1,21,15,6,71,0,2,1,1,50,3.6,4630,68
1039575-1039575-midnight_clear,7.5,25,21,4,84,0,4,3,1,75,3.7,801,79
1020451-summer_school,5.5,28,17,11,60,0,4,1,3,25,2.9,3011,55
silverado,6.8,29,22,7,75,5.8,5,3,2,60,3.5,5005,75
quick_change,6.5,27,22,5,81,5.3,8,4,4,50,3.3,2142,63
rabid,5.8,18,11,7,61,0,1,0,1,0,3.1,1745,48
radio_flyer,4.7,28,12,16,42,4.4,7,2,5,28,3.4,2859,73
star_wars_3,7.2,253,202,51,79,6.6,43,29,14,67,3.1,198824,64
secret_of_my_success,5.4,19,11,8,57,0,4,2,2,50,3,3534,57
show_me_love,7.6,39,35,4,89,7.8,10,9,1,90,3.9,4417,84
streets_of_fire,5.9,20,12,8,60,0,1,1,0,100,3.5,2031,70
teen_wolf,4.6,17,8,9,47,0,0,0,0,0,0,0,0
1038770-high_heels,5.9,12,7,5,58,0,4,1,3,25,3.9,2771,85
things_you_can_tell_just_by_looking_at_her,6.5,19,14,5,73,0,4,4,0,100,3.3,1417,61
thunderheart,6.4,15,13,2,86,0,2,1,1,50,3.4,2637,70
to_live_and_die_in_la,7.1,23,20,3,86,0,1,1,0,100,3.6,2714,74
trapped_in_paradise,3.1,20,2,18,10,2.8,7,1,6,14,2.9,2272,42
betty_blue,6.4,25,19,6,76,5.6,9,5,4,55,4.1,3961,90
my_life_to_live,7.9,26,24,2,92,7.5,6,5,1,83,4.3,2190,92
wild_at_heart,5.8,42,27,15,64,5,8,3,5,37,3.7,11690,81
1029830-witches,7.5,13,13,0,100,0,2,2,0,100,3.2,8849,61
witches_of_eastwick,6.2,26,19,7,73,0,1,1,0,100,3.2,12158,60
1024232-year_of_the_dragon,6.1,15,9,6,60,0,0,0,0,0,0,0,0
1077642-nothing_to_lose,5.1,23,6,17,26,5.7,5,1,4,20,3.1,5245,67
flying_down_to_rio,7.5,5,5,0,100,0,0,0,0,0,0,0,0
follow_the_fleet,7.1,8,6,2,75,0,0,0,0,0,0,0,0
whats_new_pussycat,5.5,10,4,6,40,0,3,1,2,33,3.3,1538,57
mary_of_scotland,0,0,0,0,0,0,0,0,0,0,0,0,0
roberta,6.6,5,4,1,80,0,0,0,0,0,0,0,0
1190049-little_women,0,0,0,0,0,0,0,0,0,0,0,0,0
1020729-swing_time,8.6,19,19,0,100,0,4,4,0,100,0,0,0
1016885-public_enemy,8.4,26,26,0,100,0,2,2,0,100,3.9,1936,84
tales-of-the-night-fairies,0,0,0,0,0,0,0,0,0,0,0,0,0
life_with_father,7.1,7,7,0,100,0,0,0,0,0,0,0,0
national_velvet,7.8,11,11,0,100,0,0,0,0,0,0,0,0
1011028-jesus_christ_superstar,5.9,21,12,9,57,0,2,1,1,50,3.4,5991,75
dark_victory,7.2,19,16,3,84,0,1,1,0,100,3.9,1297,83
birdman_of_alcatraz,6.9,15,12,3,80,0,0,0,0,0,0,0,0
aguirre_the_wrath_of_god,8.9,32,31,1,96,0,3,3,0,100,4.2,6781,91
belle-and-the-beast-a-christian-romance,0,0,0,0,0,0,0,0,0,0,0,0,0
birth_of_a_nation,8,31,31,0,100,0,4,4,0,100,3.3,1249,58
the-blue-kite,8,8,8,0,100,0,2,2,0,100,3.9,476,85
juliet_of_the_spirits,7.2,21,18,3,85,7.1,7,6,1,85,4,1862,85
l-annee-derniere-a-marienbad-last-year-at-marienbad,8.1,34,32,2,94,8.8,7,7,0,100,4.2,2222,86
1012952-macbeth,7.7,24,20,4,83,0,4,2,2,50,3.3,1824,65
red_river,8.6,18,18,0,100,0,3,3,0,100,0,0,0
woman_under_the_influence,8,19,17,2,89,0,3,3,0,100,4.3,2367,93
1019774-stagecoach,8.9,26,26,0,100,0,0,0,0,0,0,0,0
1018909-shot_in_the_dark,7.9,20,20,0,100,0,0,0,0,0,0,0,0
flight_of_the_navigator,5.7,7,5,2,71,0,0,0,0,0,0,0,0
court_jester,7.6,13,13,0,100,0,0,0,0,0,0,0,0
bullitt,7.7,33,32,1,96,7.1,5,4,1,80,3.8,8312,84
way_down_east,8.3,8,7,1,87,0,0,0,0,0,0,0,0
jezebel,7.5,13,13,0,100,0,0,0,0,0,0,0,0
1010215-hunchback_of_notre_dame,8.3,9,9,0,100,0,0,0,0,0,0,0,0
42nd_street,7.8,20,19,1,95,0,2,1,1,50,3.5,1572,71
im_no_angel,7.7,8,8,0,100,0,0,0,0,0,0,0,0
that-touch-of-mink,5.4,9,6,3,66,0,0,0,0,0,0,0,0
sweet_dreams,6.4,12,11,1,91,0,1,0,1,0,3.7,1151,77
play_it_again_sam,7.4,32,31,1,96,0,1,1,0,100,3.9,3355,86
send_me_no_flowers,6.4,7,5,2,71,0,0,0,0,0,0,0,0
1016943-pygmalion,8.2,16,15,1,93,0,3,3,0,100,3.7,900,82
passage_to_india,7.3,20,17,3,85,0,4,3,1,75,3.6,1652,74
black_orpheus,7.8,21,19,2,90,0,4,4,0,100,4,1619,86
amarcord,8.2,39,36,3,92,8.4,10,9,1,90,4.2,5273,90
the-hero2004,0,0,0,0,0,0,0,0,0,0,0,0,0
horse_feathers,8.2,24,23,1,95,0,3,3,0,100,3.9,2168,86
1001063-anna_karenina,7.4,7,7,0,100,0,0,0,0,0,0,0,0
1037105-front_page,5.8,24,16,8,66,0,1,1,0,100,3.6,905,73
rules_of_attraction,5.3,134,59,75,44,4.9,27,9,18,33,3.2,10253,71
looking_for_mr_goodbar,6.4,19,15,4,78,0,2,2,0,100,0,0,0
rivers-and-tides,8.1,70,69,1,98,7.8,21,20,1,95,4.2,236,86
girl_from_paris,6.9,41,37,4,90,7.2,15,13,2,86,3.5,505,64
nausicaa_of_the_valley_of_the_wind,8.2,8,8,0,100,0,0,0,0,0,0,0,0
crisscross,0,0,0,0,0,0,0,0,0,0,0,0,0
doc_hollywood,5.9,24,18,6,75,0,1,1,0,100,2.7,3776,43
1006250-dragnet,4.9,28,13,15,46,6.4,6,5,1,83,0,0,0
1139602-madhouse,0,1,0,1,0,0,0,0,0,0,0,0,0
1941,5.2,21,7,14,33,0,1,0,1,0,3,5333,48
shot_at_glory,6,21,14,7,66,0,4,4,0,100,3.3,476,61
black_and_white_in_color,0,4,4,0,100,0,0,0,0,0,0,0,0
1007739-foul_play,6.2,20,14,6,70,0,3,1,2,33,3.4,1837,67
1074827-crime_story,6.6,15,14,1,93,0,1,1,0,100,3.3,1708,60
beyond_the_clouds,6.4,20,13,7,65,0,4,3,1,75,3.6,976,68
ryans_daughter,5.5,16,8,8,50,5.5,5,2,3,40,3.9,717,79
1144992-crash,7.1,197,148,49,75,7.1,39,30,9,76,4,98746,89
cabeza-de-vaca,0,0,0,0,0,0,0,0,0,0,0,0,0
bone_collector,4.7,84,23,61,27,4.7,23,7,16,30,3.3,26317,68
deep_red_the_hatchet_murders,8,18,18,0,100,0,0,0,0,0,0,0,0
1032980-diabolique,8.2,23,22,1,95,7.8,5,4,1,80,4.1,3066,91
leprechaun,4,10,3,7,30,0,1,0,1,0,2.5,4764,38
wings_of_honneamise,6.9,9,9,0,100,0,3,3,0,100,3.7,1212,75
movie_crazy,0,1,0,1,0,0,0,0,0,0,0,0,0
dark-wolf,0,0,0,0,0,0,0,0,0,0,0,0,0
1000253-adams_rib,8.2,23,23,0,100,0,3,3,0,100,3.9,3056,85
1011624-king_of_hearts,7.4,10,9,1,90,0,2,1,1,50,4,779,86
naked_lunch,6.8,31,21,10,67,0,2,1,1,50,3.6,7592,78
grass_is_greener,6.6,7,7,0,100,0,0,0,0,0,0,0,0
spring_forward,7.5,22,19,3,86,0,2,2,0,100,3.8,237,78
killing_of_a_chinese_bookie,6.2,15,12,3,80,0,2,1,1,50,3.9,1173,83
10008621-run_fat_boy_run,5.5,143,69,74,48,5.5,31,17,14,54,3.5,43462,66
things_to_come,7.5,20,19,1,95,0,3,2,1,66,3.3,608,54
queen_of_hearts,0,3,2,1,66,0,1,1,0,100,0,0,0
my_darling_clementine,8.7,22,22,0,100,0,1,1,0,100,3.8,1741,83
summer_place,6,6,5,1,83,0,0,0,0,0,0,0,0
1015002-night_at_the_opera,8.5,33,32,1,96,0,3,2,1,66,4.1,4515,90
metalstorm_the_destruction_of_jaredsyn,0,0,0,0,0,0,0,0,0,0,0,0,0
element_of_crime,6.3,13,10,3,76,0,0,0,0,0,0,0,0
shoot_the_piano_player,8.6,18,17,1,94,0,3,2,1,66,0,0,0
stolen_kisses,7.7,16,15,1,93,0,1,1,0,100,4,1610,88
cooler,6.7,168,129,39,76,7.2,36,32,4,88,3.3,3858,68
el_bonaerense,6.7,11,10,1,90,6.6,5,4,1,80,3.1,27,53
in_america,7.7,170,151,19,88,7.8,40,37,3,92,3.8,6695,89
my_flesh_and_blood,7.6,30,27,3,90,7.8,11,10,1,90,4,459,89
honey,4.1,111,22,89,19,4.1,30,5,25,16,3.4,89773,76
last_samurai,6.4,213,138,75,64,5.9,41,23,18,56,3.7,87574,82
forget_baghdad,6.9,12,9,3,75,0,4,3,1,75,3.5,42,56
what_alice_found,6.3,38,26,12,68,6.8,11,9,2,81,3.1,213,46
1127787-big_fish,7.2,211,161,50,76,6.4,41,25,16,60,3.7,112139,86
love_dont_cost_a_thing,3.7,71,9,62,12,4.1,24,4,20,16,3.1,6106,70
somethings_gotta_give,6.5,163,115,48,70,6.8,39,29,10,74,3.2,24174,68
stuck_2003,0,0,0,0,0,0,0,0,0,0,0,0,0
girl_with_a_pearl_earring,6.8,172,123,49,71,6.7,39,30,9,76,3.4,16783,67
statement,4.7,106,25,81,23,4.5,32,6,26,18,3,654,38
lord_of_the_rings_the_return_of_the_king,8.6,239,225,14,94,8.6,43,42,1,97,3.7,288649,83
mona_lisa_smile,4.9,147,51,96,34,5.2,41,18,23,43,3.1,23577,61
calendar_girls,6.5,118,87,31,73,6.5,33,23,10,69,3.1,8453,59
fog_of_war,8.4,135,132,3,97,8.4,35,34,1,97,4.1,4231,92
hebrew_hammer,5.1,23,12,11,52,4.8,12,6,6,50,3.2,1577,61
house_of_sand_and_fog,7.1,168,126,42,75,7.9,33,29,4,87,3.6,8761,81
two_men_went_to_war,5.6,27,17,10,62,5.1,8,4,4,50,3.3,218,63
1128647-monster,7.2,182,149,33,81,7.4,37,33,4,89,3.5,17719,78
cheaper_by_the_dozen,4.6,111,26,85,23,4.9,31,10,21,32,3.1,62198,65
cold_mountain,6.7,221,156,65,70,7.5,42,38,4,90,3.3,26002,74
paycheck,4.7,151,42,109,27,4.5,31,4,27,12,2.9,19654,52
1128577-peter_pan,6.8,132,100,32,75,6.3,33,23,10,69,3.3,47413,68
1128345-company,6.6,124,86,38,69,6.6,31,20,11,64,3,1840,43
young_black_stallion,5.4,39,17,22,43,5.7,14,7,7,50,3.6,930,72
japanese_story,6.4,89,60,29,67,6.5,30,21,9,70,3.5,1232,70
secret_things,5.6,49,24,25,48,5.3,19,8,11,42,3,168,40
italians-in-america-our-contribution,0,0,0,0,0,0,0,0,0,0,0,0,0
my_babys_daddy,2.8,51,2,49,3,3.1,17,1,16,5,3.1,1999,57
aileen_the_life_and_death_of_a_serial_killer,7.1,57,49,8,85,7.3,20,18,2,90,3.5,1623,72
distant,7.8,43,38,5,88,7.9,16,15,1,93,3.9,1453,82
along_came_polly,4.8,152,39,113,25,4.7,36,8,28,22,3.1,42224,54
1129129-teachers_pet,6.5,72,54,18,75,6.7,25,19,6,76,2.8,370,38
1129132-torque,4.2,111,25,86,22,4.3,30,6,24,20,2.9,17598,55
crimson_gold,7.5,73,63,10,86,8,25,24,1,96,3.7,506,77
osama,7.8,101,97,4,96,8,35,34,1,97,3.9,1868,86
1008799-great_gatsby,4.8,26,10,16,38,0,4,0,4,0,3.2,3750,56
1024192-wuthering_heights,7.9,16,16,0,100,0,1,1,0,100,3.9,2525,84
odds_against_tomorrow,0,2,2,0,100,0,0,0,0,0,0,0,0
ship_of_fools,6.8,16,13,3,81,0,3,2,1,66,3.6,400,74
lord-love-a-duck,6.9,7,5,2,71,0,0,0,0,0,0,0,0
theres_a_girl_in_my_soup,0,2,1,1,50,0,0,0,0,0,0,0,0
this_property_is_condemned,5.5,14,9,5,64,0,3,2,1,66,3.8,780,75
what_doesnt_kill_you,6,32,21,11,65,6.3,10,8,2,80,3.1,2596,45
once_upon_a_crime,3.7,6,0,6,0,0,0,0,0,0,0,0,0
beyond_therapy,4.2,8,2,6,25,0,3,0,3,0,2.7,388,34
1008166-general,8.9,38,35,3,92,0,4,2,2,50,4.4,3785,93
car_54_where_are_you,1.9,13,0,13,0,0,3,0,3,0,2.2,859,22
blame_it_on_the_bellboy,2.4,9,1,8,11,0,0,0,0,0,0,0,0
only_the_strong,2.8,7,0,7,0,2.5,5,0,5,0,3.7,1259,79
adventures_of_ford_fairlane,3.5,22,6,16,27,0,2,0,2,0,3.2,2144,66
bonjour_tristesse,6.7,13,11,2,84,0,3,1,2,33,3.6,458,67
1006646-enforcer,6.3,26,20,6,76,0,1,1,0,100,3.4,3350,61
xmen,7,152,124,28,81,5.8,32,19,13,59,3.7,133573,83
1074298-ransom,6.4,30,21,9,70,5.7,7,4,3,57,3.1,10364,61
pickup_artist,5,20,11,9,55,5.2,6,3,3,50,2.8,1355,34
melvin_goes_to_dinner,7.3,11,11,0,100,0,3,3,0,100,3.6,651,77
the-courtmartial-of-billy-mitchell,7.4,5,5,0,100,0,1,1,0,100,3.5,225,60
crime_spree,5.8,6,3,3,50,0,4,2,2,50,3.3,616,57
beyond_reanimator,5.2,11,5,6,45,0,1,0,1,0,3,2279,42
final_cut,5.4,75,29,46,38,4.9,26,8,18,30,3,4745,48
1009470-hells_angels_on_wheels,4.4,7,2,5,28,0,1,0,1,0,3,814,39
wind_and_the_lion,6,10,6,4,60,0,0,0,0,0,0,0,0
mon_oncle,8.5,17,16,1,94,0,2,1,1,50,4.2,2439,89
1023508-where_the_boys_are,0,4,3,1,75,0,0,0,0,0,0,0,0
dr_jekyll_and_mr_hyde,0,1,0,1,0,0,0,0,0,0,0,0,0
mr_hulots_holiday,8.8,24,24,0,100,0,3,3,0,100,4,2052,86
my_darling_clementine,8.7,22,22,0,100,0,1,1,0,100,3.8,1741,83
people_will_talk,0,4,4,0,100,0,0,0,0,0,0,0,0
i_was_a_male_war_bride,6.7,14,11,3,78,0,2,1,1,50,3.6,1412,71
divorce_american_style,6.6,5,4,1,80,0,1,1,0,100,3.2,434,44
kiss_them_for_me,0,1,0,1,0,0,0,0,0,0,0,0,0
to_have_and_have_not,8.1,21,21,0,100,0,3,3,0,100,4.1,3565,90
high_sierra,7.8,16,15,1,93,0,0,0,0,0,0,0,0
dark_passage,7.6,14,13,1,92,0,0,0,0,0,0,0,0
oxbow_incident,8.1,17,16,1,94,0,0,0,0,0,0,0,0
1021214-they_drive_by_night,6.8,17,16,1,94,0,0,0,0,0,0,0,0
micki_and_maude,5.3,6,4,2,66,0,1,1,0,100,2.9,446,41
1038237-platinum_blonde,7.2,6,6,0,100,0,0,0,0,0,0,0,0
reefer_madness,4.8,24,11,13,45,0,1,1,0,100,3,2726,45
doa_dead_or_alive,4.5,44,15,29,34,4.2,10,2,8,20,2.7,71044,43
boy_with_green_hair,7.1,8,6,2,75,0,0,0,0,0,0,0,0
pumping_iron,7.3,23,22,1,95,0,4,4,0,100,0,0,0
no_good_deed,4,10,2,8,20,4.3,5,1,4,20,2.9,933,34
trouble_with_angels,0,4,4,0,100,0,0,0,0,0,0,0,0
1040378-cool_world,3.2,31,2,29,6,0,4,0,4,0,2.6,8556,35
money_for_nothing,0,4,1,3,25,0,1,0,1,0,2.8,839,31
1111123-silencers,0,1,0,1,0,0,0,0,0,0,0,0,0
where_angels_go_trouble_follows,0,1,0,1,0,0,0,0,0,0,0,0,0
heat_and_dust,0,4,4,0,100,0,1,1,0,100,3.5,237,54
la_strada,8.7,31,30,1,96,0,4,3,1,75,4.3,5992,94
ichi_the_killer,6.1,35,22,13,62,4.2,8,2,6,25,3.9,12533,83
boy_and_his_dog,6.6,30,23,7,76,0,3,0,3,0,3.4,2758,62
last_tycoon,5.4,18,8,10,44,0,3,1,2,33,3.2,859,49
ashes_and_diamonds,8.4,8,7,1,87,0,0,0,0,0,0,0,0
marooned,6.7,5,5,0,100,0,1,1,0,100,3,377,40
king_david,3,8,1,7,12,0,0,0,0,0,0,0,0
kanal-1957,0,0,0,0,0,0,0,0,0,0,0,0,0
cat_chaser,4.8,5,2,3,40,0,0,0,0,0,0,0,0
1010644-intolerance,7.8,23,22,1,95,0,3,3,0,100,3.8,1397,77
beast_of_yucca_flats,0,3,0,3,0,0,0,0,0,0,0,0,0
1021711-torment,7,6,5,1,83,0,2,1,1,50,3.8,348,76
chitty_chitty_bang_bang,5.4,22,13,9,59,0,2,2,0,100,3.2,18830,65
legend_of_suriyothai,5.6,58,31,27,53,5.3,19,8,11,42,3.4,414,60
plaza_suite,5.5,6,3,3,50,0,0,0,0,0,0,0,0
1087047-outoftowners,5,34,8,26,23,4.9,5,1,4,20,2.6,2186,33
where_the_day_takes_you,5.6,5,3,2,60,0,1,1,0,100,3.6,904,72
three_stooges_three_stooges_in_orbit,0,0,0,0,0,0,0,0,0,0,0,0,0
1010770-it,6.6,8,8,0,100,0,1,1,0,100,3.7,773,78
butterfly_effect,4.8,166,55,111,33,3.8,34,6,28,17,3.6,109956,81
win_a_date_with_tad_hamilton,5.6,142,74,68,52,5.2,35,14,21,40,2.9,10675,48
touching_the_void,8,136,127,9,93,7.6,37,34,3,91,4.1,3095,91
big_bounce,4,132,21,111,15,3.8,35,4,31,11,2.5,3228,26
perfect_score,3.7,107,18,89,16,3.7,30,6,24,20,2.9,7659,50
omarion-invitation-only,0,0,0,0,0,0,0,0,0,0,0,0,0
latter_days,5.4,46,20,26,43,5.4,16,7,9,43,4,3579,82
barbershop_2_back_in_business,6.3,123,84,39,68,6.4,34,23,11,67,3.1,7601,58
catch_that_kid,3.8,84,9,75,10,3.7,27,2,25,7,3.1,5038,56
miracle,7,156,124,32,79,6.8,37,29,8,78,3.7,11958,88
un-couple-epatant-trilogy-two,0,0,0,0,0,0,0,0,0,0,0,0,0
lost_skeleton_of_cadavra,5.9,68,36,32,52,6.1,19,11,8,57,3.9,1458,84
whos_the_man,5.3,7,3,4,42,0,2,1,1,50,2.9,682,50
hangin_with_the_homeboys,7.1,5,4,1,80,0,2,2,0,100,3.3,433,57
sleep_with_me,4.6,12,2,10,16,0,3,0,3,0,3.2,521,48
just_between_friends,4.6,6,2,4,33,0,1,0,1,0,3,662,39
superfly,7.1,21,19,2,90,0,3,3,0,100,3.5,1082,70
piece_of_the_action,0,1,1,0,100,0,0,0,0,0,0,0,0
lets-do-it-again-1953,0,0,0,0,0,0,0,0,0,0,0,0,0
uptown_saturday_night,6.4,7,5,2,71,0,0,0,0,0,0,0,0
hells_kitchen,4.6,5,2,3,40,0,0,0,0,0,0,0,0
presumed_innocent,7.2,31,29,2,93,7.5,8,8,0,100,3.2,3836,60
daddy_and_them,6.3,6,5,1,83,0,0,0,0,0,0,0,0
wilby_conspiracy,0,3,2,1,66,0,0,0,0,0,0,0,0
blacula,5.1,19,8,11,42,0,2,1,1,50,2.8,1108,42
scream_blacula_scream,0,3,1,2,33,0,0,0,0,0,0,0,0
swing_shift,7.2,6,6,0,100,0,1,1,0,100,2.9,671,31
trespass,6.1,22,15,7,68,5.5,6,3,3,50,3,1402,48
oceans_thirteen,6.4,195,136,59,69,6,43,25,18,58,3.6,846364,74
simple_men,7.1,10,9,1,90,0,2,1,1,50,3.9,685,88
foolish-wives,9,7,7,0,100,0,0,0,0,0,0,0,0
silent_night_bloody_night,0,2,0,2,0,0,0,0,0,0,0,0,0
sin_of_harold_diddlebock,6.7,9,8,1,88,0,2,2,0,100,3.3,264,54
across_the_moon,0,0,0,0,0,0,0,0,0,0,0,0,0
1002061-best_defense,0,4,0,4,0,0,1,0,1,0,2.4,1191,19
50_first_dates,5.4,172,76,96,44,5.3,38,18,20,47,3.4,217959,68
welcome_to_mooseport,4.2,144,19,125,13,4.3,38,6,32,15,2.5,2414,24
after_the_life,7.2,33,31,2,93,7.7,12,12,0,100,3.8,54,75
kitchen_stories,7.3,75,67,8,89,7.1,25,24,1,96,4,1308,86
the-code,0,0,0,0,0,0,0,0,0,0,0,0,0
monsieur_ibrahim,7,80,68,12,85,7.4,25,24,1,96,3.9,1791,85
1022504-vanishing_point,6.3,16,12,4,75,0,4,2,2,50,3.9,4207,81
diary_of_a_country_priest,8.3,17,15,2,88,0,2,1,1,50,4.1,1108,88
1028714-thief_of_bagdad,8.1,13,13,0,100,0,1,1,0,100,3.6,655,75
diary_of_anne_frank,6.8,15,11,4,73,0,2,1,1,50,3.5,6344,74
allegro-non-troppo,7.3,17,15,2,88,0,1,1,0,100,3.8,1302,81
10010172-black_widow,0,1,0,1,0,0,0,0,0,0,0,0,0
la_ley_de_herodes,6.4,25,17,8,68,6.3,10,7,3,70,4,575,88
1007538-flesh_and_blood,6,8,6,2,75,0,0,0,0,0,0,0,0
1011638-king_solomons_mines,7.4,11,10,1,90,0,0,0,0,0,0,0,0
1002511-black_pirate,8.1,7,7,0,100,0,0,0,0,0,0,0,0
1017226-raw_deal,3.8,12,3,9,25,0,1,0,1,0,2.7,3041,32
1008627-goodbye_mr_chips,7.8,16,13,3,81,0,0,0,0,0,0,0,0
follow_me_boys,0,0,0,0,0,0,0,0,0,0,0,0,0
fire_birds,3.1,15,1,14,6,0,4,0,4,0,2.9,1449,41
robot_stories,6.6,42,30,12,71,6.6,15,11,4,73,3.1,471,51
against_the_ropes,4.2,131,16,115,12,4.3,34,6,28,17,2.8,1809,35
confessions_of_a_teenage_drama_queen,3.8,88,11,77,12,3.8,25,3,22,12,2.7,33054,48
the-trip-2005,0,0,0,0,0,0,0,0,0,0,0,0,0
passion_of_the_christ,5.8,262,130,132,49,4.9,47,17,30,36,3.7,51559,84
club-dread,4.4,98,29,69,29,4.3,26,7,19,26,2.7,7120,45
havana_nights,4.3,105,24,81,22,3.7,34,4,30,11,3.2,46963,71
twisted,2.9,132,2,130,1,3.2,36,0,36,0,2.8,2961,40
alila,5.3,17,7,10,41,5.2,6,2,4,33,3,221,40
good_bye_lenin,7.4,105,94,11,89,6.6,28,23,5,82,4,16904,91
hidalgo,5.6,157,73,84,46,5.5,36,16,20,44,3.2,13730,70
starsky_and_hutch,6,188,120,68,63,6,41,28,13,68,3,28412,54
1130191-reckoning,5.6,85,34,51,40,5.5,28,12,16,42,3.3,1019,60
persona,8.6,29,27,2,93,0,4,3,1,75,4.4,7552,94
passion_of_anna,8.2,11,11,0,100,0,2,2,0,100,4,746,85
walk_on_the_wild_side,0,4,2,2,50,0,0,0,0,0,0,0,0
tokyo_joe,0,3,2,1,66,0,0,0,0,0,0,0,0
serpents_egg,4.5,12,3,9,25,0,4,0,4,0,3.3,729,58
1078038-fire_down_below,3.3,26,3,23,11,3.3,7,1,6,14,2.6,3327,48
le_corbeau,7.7,23,20,3,86,0,3,1,2,33,4,807,90
1000642-all_quiet_on_the_western_front,8.6,32,31,1,96,7.8,5,5,0,100,3.8,3797,85
pickup_on_south_street,7.6,25,22,3,88,0,3,1,2,33,4,1058,89
1005155-damned,8.1,10,9,1,90,0,1,1,0,100,4,255,82
american_gun,5.3,30,11,19,36,5,12,4,8,33,3.2,1027,49
1068177-richard_iii,8.1,43,41,2,95,7.6,11,10,1,90,3.7,1552,82
1016958-quartet,0,2,0,2,0,0,0,0,0,0,0,0,0
just_one_of_the_guys,4.6,10,4,6,40,0,2,0,2,0,3.3,2022,66
1003957-chase,6.5,5,4,1,80,0,0,0,0,0,0,0,0
last_kiss,5.7,124,57,67,45,6,31,15,16,48,3.2,37077,59
wisconsin_death_trip,6.4,11,9,2,81,0,3,2,1,66,3.5,346,66
wrong_arm_of_the_law,0,0,0,0,0,0,0,0,0,0,0,0,0
agent_cody_banks_2_destination_london,3.4,91,11,80,12,3.9,24,4,20,16,2.5,13037,41
1130343-girl_next_door,5.6,156,87,69,55,5,32,17,15,53,3.3,39311,71
secret_window,5.5,158,73,85,46,5.5,37,18,19,48,3.3,56932,69
spartan,6.5,131,84,47,64,6.3,41,22,19,53,3.3,3343,61
broken-wings,7.3,67,62,5,92,7.4,22,21,1,95,4,613,87
how_to_draw_a_bunny,7,27,22,5,81,6.6,8,6,2,75,3.9,404,81
wilbur_wants_to_kill_himself,7.1,78,67,11,85,6.8,26,20,6,76,3.5,1296,69
cliffords_really_big_movie,5.6,31,16,15,51,5.6,12,6,6,50,3,524,41
mad_dog_and_glory,6.2,26,20,6,76,6.2,6,4,2,66,3,2359,41
mr_toads_wild_ride,6.9,8,6,2,75,0,0,0,0,0,0,0,0
night_crossing,0,3,3,0,100,0,0,0,0,0,0,0,0
peyton_place,6.1,9,5,4,55,0,0,0,0,0,0,0,0
searching_for_debra_winger,0,4,3,1,75,0,1,1,0,100,3.2,487,50
walk_like_a_man,0,1,0,1,0,0,0,0,0,0,0,0,0
dawn_of_the_dead,6.7,171,130,41,76,6.1,32,20,12,62,3.4,49706,75
eternal_sunshine_of_the_spotless_mind,8.3,216,200,16,92,7.9,42,38,4,90,4,177263,93
taking_lives,4.6,155,35,120,22,4.7,37,10,27,27,3.2,13988,63
intermission,6.6,96,70,26,72,6.8,28,21,7,75,3.6,2948,76
noi-the-albino,7,53,46,7,86,6.4,15,12,3,80,3.9,1758,85
jersey_girl,5.3,169,69,100,40,4.7,38,12,26,31,2.9,16772,52
ladykillers,6.1,185,101,84,54,5.8,39,18,21,46,2.8,12107,40
never_die_alone,4.1,89,23,66,25,4.3,28,8,20,28,3.3,2511,65
scoobydoo-2-monsters-unleashed,4.2,111,24,87,21,3.6,25,3,22,12,2.7,15310,57
foreign_affair,7.6,9,9,0,100,0,2,2,0,100,3.7,504,75
dogville,6.9,152,106,46,69,6.8,40,28,12,70,4,17210,88
1131148-ned_kelly,5.7,54,30,24,55,5.2,15,4,11,26,3.2,7741,60
hellboy,6.8,195,157,38,80,6.8,38,33,5,86,3.2,65444,63
home_on_the_range,5.7,120,65,55,54,5.3,30,11,19,36,2.8,4447,44
prince_and_me,4.8,118,33,85,27,4.5,32,7,25,21,3.1,29626,67
walking_tall,4.4,130,32,98,24,4.6,34,7,27,20,3.2,20192,71
united_states_of_leland,4.9,87,29,58,33,4.5,27,7,20,25,3.8,6163,83
general-santa-ana,0,0,0,0,0,0,0,0,0,0,0,0,0
ella_enchanted,5.6,113,56,57,49,5.7,30,14,16,46,3.1,50156,62
whole_ten_yards,2.8,116,5,111,4,3.3,31,2,29,6,3,11437,51
im_not_scared,7.5,98,88,10,89,7.3,32,28,4,87,3.9,1989,87
shade,5.8,15,10,5,66,0,3,2,1,66,3.3,1382,60
since_otar_left,7.9,55,54,1,98,8.1,20,20,0,100,4,492,84
twentynine_palms,4.9,36,16,20,44,4.6,13,4,9,30,2.8,474,44
1021015-ten_commandments,7.3,29,26,3,89,0,4,2,2,50,3.6,11440,83
dawn_of_the_dead,6.7,171,130,41,76,6.1,32,20,12,62,3.4,49706,75
brother_sun_sister_moon,5.6,8,5,3,62,0,1,0,1,0,3.8,742,77
one_million_years_bc,5.5,6,3,3,50,0,0,0,0,0,0,0,0
prey_for_rock_and_roll,5.8,46,26,20,56,6.3,14,10,4,71,3.4,876,66
mother_jugs_and_speed,5.4,13,7,6,53,0,2,1,1,50,0,0,0
bandolero2004,0,0,0,0,0,0,0,0,0,0,0,0,0
sluggers_wife,3.3,8,0,8,0,0,2,0,2,0,2.8,189,24
those_magnificent_men_in_their_flying_machines,5.8,6,4,2,66,0,0,0,0,0,0,0,0
cheaper_by_the_dozen,4.6,111,26,85,23,4.9,31,10,21,32,3.1,62198,65
scenes_from_a_marriage,8.5,16,15,1,93,0,3,2,1,66,4.4,2761,93
baby_the_rain_must_fall,0,3,3,0,100,0,0,0,0,0,0,0,0
belles_on_their_toes,0,1,1,0,100,0,0,0,0,0,0,0,0
1131148-ned_kelly,5.7,54,30,24,55,5.2,15,4,11,26,3.2,7741,60
mac_and_me,2.4,14,0,14,0,0,2,0,2,0,2.7,2264,43
the-food-of-the-gods,3.6,14,3,11,21,0,1,0,1,0,2.8,401,31
miracle_at_st_anna,5.2,113,38,75,33,4.8,32,8,24,25,3.3,8435,56
road_to_bali,0,4,2,2,50,0,0,0,0,0,0,0,0
flying_deuces,6,6,5,1,83,0,0,0,0,0,0,0,0
africa_screams,0,4,2,2,50,0,0,0,0,0,0,0,0
1112265-jack_and_the_beanstalk,0,3,1,2,33,0,0,0,0,0,0,0,0
1080128-high_risk,0,3,2,1,66,0,1,1,0,100,0,0,0
osterman_weekend,5.5,14,6,8,42,0,3,0,3,0,3,724,40
harold_and_kumar_go_to_white_castle,6.5,144,106,38,73,6.7,30,22,8,73,3.5,61100,79
hangmans_curse,2.9,6,0,6,0,0,2,0,2,0,3.7,1853,77
going_in_style,0,4,4,0,100,0,0,0,0,0,0,0,0
1020488-sunshine_boys,7.1,15,14,1,93,0,0,0,0,0,0,0,0
jersey_girl,5.3,169,69,100,40,4.7,38,12,26,31,2.9,16772,52
american-nightmare2002,0,0,0,0,0,0,0,0,0,0,0,0,0
1032180-after_hours,7.8,37,34,3,91,6.7,5,4,1,80,3.8,5298,85
viva_las_vegas,6.6,22,18,4,81,0,3,3,0,100,3.4,1800,71
connie_and_carla,5.1,119,52,67,43,5.3,32,17,15,53,3.4,3049,66
kill_bill_vol_2,7.7,226,193,33,85,7.7,43,35,8,81,3.8,162324,87
punisher_war_zone,4.2,96,25,71,26,3.7,21,1,20,4,3,29393,47
paperclips,6.3,52,37,15,71,6.8,16,13,3,81,3.8,723,75
thousand_cloud_of_peace,4.6,26,8,18,30,3.7,10,2,8,20,3.2,105,48
young_adam,6.3,116,72,44,62,6.4,32,20,12,62,3.1,2330,48
13_going_on_30,6.2,161,104,57,64,6.6,35,26,9,74,3.3,96034,70
man_on_fire,5.2,157,61,96,38,5.1,38,14,24,36,3.9,67139,89
cliffords_really_big_movie,5.6,31,16,15,51,5.6,12,6,6,50,3,524,41
mc5-a-true-testimonial,7.2,15,14,1,93,7,7,6,1,85,4.5,88,96
1131155-envy,3.1,114,8,106,7,2.9,33,0,33,0,2.5,7245,33
godsend,3.4,135,6,129,4,3.3,35,1,34,2,2.5,5199,29
laws_of_attraction,4.5,143,26,117,18,4.4,39,7,32,17,2.9,5210,49
mean_girls,6.9,170,141,29,82,6.6,40,31,9,77,3,245101,66
the_wrestler,8.3,207,202,5,97,8.2,37,36,1,97,3.9,57550,86
new_york_minute,3.5,115,13,102,11,3.7,31,4,27,12,3,18023,57
unhuman,0,0,0,0,0,0,0,0,0,0,0,0,0
mudge_boy,6.4,26,20,6,76,6.4,13,10,3,76,3.7,728,73
my_bloody_valentine_3_d,5.7,85,48,37,56,5.2,8,3,5,37,3.1,111307,49
breakin_all_the_rules,4.8,86,28,58,32,5,28,11,17,39,3.3,2699,64
troy,6,216,118,98,54,6.2,43,28,15,65,3.5,148904,74
carandiru,6.6,77,53,24,68,7.4,29,25,4,86,3.9,2413,83
coffee_and_cigarettes,6.2,118,75,43,63,6.2,36,25,11,69,3.5,10991,75
strayed,6.6,58,43,15,74,6.8,21,16,5,76,3.5,542,61
boys_in_the_band,7.1,15,15,0,100,0,0,0,0,0,0,0,0
swimming-to-cambodia,7.8,8,8,0,100,0,1,1,0,100,4.1,390,92
watch_on_the_rhine,0,2,1,1,50,0,0,0,0,0,0,0,0
courage_under_fire,7.3,52,44,8,84,7.8,15,14,1,93,3.2,6918,61
enemy_mine,5.7,22,13,9,59,0,1,0,1,0,3.3,3733,69
dragon-since-1973,0,0,0,0,0,0,0,0,0,0,0,0,0
foreign_land,0,2,1,1,50,0,0,0,0,0,0,0,0
gimme_shelter,9.1,20,20,0,100,0,2,2,0,100,4,1625,90
good_morning,8.1,11,9,2,81,0,1,0,1,0,4,948,87
1083093-happy_together,7.1,31,24,7,77,7.1,9,7,2,77,4.1,4907,90
henry_and_june,6,14,9,5,64,0,1,1,0,100,3.5,2170,67
berkeley_in_the_sixties,8.1,5,5,0,100,0,1,1,0,100,3.8,195,74
nasty_girl,7.6,5,3,2,60,0,1,0,1,0,3.6,464,71
1084607-at_first_sight,5.2,36,12,24,33,5.4,6,1,5,16,2.9,2600,48
naked_prey,6.8,11,9,2,81,0,1,0,1,0,3.8,541,80
personal_journey_with_martin_scorsese_through_american_movies,8.5,10,10,0,100,0,0,0,0,0,0,0,0
three_faces_of_eve,7.7,12,12,0,100,0,1,1,0,100,3.7,997,77
1015199-no_mercy,3.4,13,2,11,15,4.4,5,2,3,40,2.8,740,32
1005724-desperate_hours,7,5,4,1,80,0,0,0,0,0,0,0,0
100_girls,5.9,5,3,2,60,0,0,0,0,0,0,0,0
failsafe,7.6,13,12,1,92,0,0,0,0,0,0,0,0
dobermann,0,1,0,1,0,0,0,0,0,0,0,0,0
the-discovery-of-heaven,0,0,0,0,0,0,0,0,0,0,0,0,0
kwaidan,7.5,16,13,3,81,0,2,1,1,50,4.1,1525,89
cat-women-of-the-moon,0,0,0,0,0,0,0,0,0,0,0,0,0
28_up,8.8,12,12,0,100,0,3,3,0,100,4.2,565,93
last_chance_harvey,6.2,146,102,44,69,6.1,27,19,8,70,3.2,14302,52
you_only_live_twice,6.1,33,23,10,69,4.8,6,1,5,16,3.4,11073,70
octopussy,5.3,32,15,17,46,4.7,5,2,3,40,3.1,10228,55
blue_gardenia,6.6,5,5,0,100,0,0,0,0,0,0,0,0
wit,6.5,10,8,2,80,0,0,0,0,0,0,0,0
never_say_never_again,5.9,34,22,12,64,6.2,5,3,2,60,3.1,7414,48
maborosi,8.1,16,16,0,100,0,4,4,0,100,4,530,83
1013035-magic_flute,7.8,14,13,1,92,0,3,3,0,100,3.8,1181,77
midnight_movie,0,1,1,0,100,0,0,0,0,0,0,0,0
1153077-1153077-pride_and_prejudice,7.7,164,140,24,85,7.6,37,32,5,86,3.8,101164,88
man_in_the_gray_flannel_suit,5.9,6,5,1,83,0,0,0,0,0,0,0,0
fountainhead,6.4,11,9,2,81,0,0,0,0,0,0,0,0
old_acquaintance,0,1,0,1,0,0,0,0,0,0,0,0,0
in_this_our_life,0,3,2,1,66,0,0,0,0,0,0,0,0
10009516-women,3.9,142,18,124,12,3.8,34,4,30,11,3,20081,41
summertime,7.4,14,13,1,92,0,3,3,0,100,3.7,859,78
soldier_of_orange,7.9,8,8,0,100,0,0,0,0,0,0,0,0
le_samourai,8.3,25,25,0,100,8.4,7,7,0,100,0,0,0
white_palace,5.6,14,8,6,57,0,2,2,0,100,3.2,887,63
oklahoma,7.2,22,20,2,90,0,4,3,1,75,3.4,4365,72
desert_hearts,6.8,5,4,1,80,0,1,0,1,0,3.7,699,72
body_double,6.6,25,21,4,84,0,1,1,0,100,3.2,1914,61
rooster-cogburn,4.7,7,3,4,42,0,1,0,1,0,0,0,0
chaplin,5.8,44,27,17,61,3.3,9,0,9,0,3.6,6022,81
1013973-miracle_worker,7.8,17,17,0,100,0,3,3,0,100,3.7,1889,83
monster_in_a_box,6.6,14,13,1,92,0,2,2,0,100,4.2,127,98
vengo,5.7,37,23,14,62,5.2,13,6,7,46,4,644,84
1095460-midnight,0,1,1,0,100,0,0,0,0,0,0,0,0
if_you_only_knew,0,1,1,0,100,0,0,0,0,0,0,0,0
school_ties,5.8,35,23,12,65,4.9,7,3,4,42,3.3,5052,69
calendar_girls,6.5,118,87,31,73,6.5,33,23,10,69,3.1,8453,59
1034067-switch,4.7,16,5,11,31,0,2,0,2,0,2.8,1035,47
just_write,5,6,3,3,50,0,0,0,0,0,0,0,0
raising_cain,4.4,19,10,9,52,0,1,1,0,100,2.9,1825,40
irma_vep,7.4,35,32,3,91,7.5,11,10,1,90,3.5,738,67
buck_privates,0,0,0,0,0,0,0,0,0,0,0,0,0
nice_guys_sleep_alone,0,2,2,0,100,0,0,0,0,0,0,0,0
divorce-iranian-style,0,0,0,0,0,0,0,0,0,0,0,0,0
iron_and_silk,6.3,5,4,1,80,0,0,0,0,0,0,0,0
red2002,0,0,0,0,0,0,0,0,0,0,0,0,0
noises_off,5.7,21,12,9,57,0,0,0,0,0,0,0,0
1039504-wildflower,0,1,0,1,0,0,0,0,0,0,0,0,0
conqueror_worm,6.9,12,10,2,83,0,1,1,0,100,3.5,1271,68
1067316-canterville_ghost,0,0,0,0,0,0,0,0,0,0,0,0,0
prince_and_the_showgirl,6,5,4,1,80,0,0,0,0,0,0,0,0
china_syndrome,7.4,27,23,4,85,0,4,3,1,75,3.6,2169,76
who_the_hell_is_juliette,6.4,6,4,2,66,0,1,1,0,100,3.4,65,58
wages_of_fear,8.8,36,36,0,100,8.8,6,6,0,100,4.4,2478,94
look_whos_talking_too,2.8,12,2,10,16,0,1,1,0,100,2.6,9775,43
bells_of_st_marys,7.2,15,14,1,93,0,3,3,0,100,3.7,1566,76
you_light_up_my_life,3.2,5,1,4,20,0,0,0,0,0,0,0,0
delta_force_2,2.2,7,0,7,0,0,1,0,1,0,2.9,1781,45
pat_and_mike,7.4,20,18,2,90,7.2,6,6,0,100,3.5,815,67
animal_crackers,8,20,19,1,95,0,0,0,0,0,0,0,0
he_said_she_said,4.9,14,5,9,35,0,2,0,2,0,2.7,1214,33
1101051-bedazzled,5.4,109,53,56,48,5.2,32,14,18,43,2.7,15017,45
1003758-cat_people,6.1,36,23,13,63,0,3,2,1,66,3,2400,46
quest_for_camelot,5.3,21,7,14,33,5.9,6,2,4,33,3.1,4042,62
lonely_guy,5.2,21,10,11,47,0,4,0,4,0,3.1,985,48
four_musketeers,6.9,18,14,4,77,0,1,0,1,0,3.4,1319,68
good_guys_wear_black,0,4,1,3,25,0,0,0,0,0,0,0,0
steel_dawn,0,2,1,1,50,0,0,0,0,0,0,0,0
on_deadly_ground,2.3,23,0,23,0,2.4,5,0,5,0,2.5,3925,45
1032409-boy_meets_girl,0,1,1,0,100,0,0,0,0,0,0,0,0
fourth_protocol,5.7,14,9,5,64,0,2,2,0,100,3.4,544,58
1016592-postman_always_rings_twice,6.3,10,7,3,70,0,1,0,1,0,3.3,2610,61
1041870-matinee,7.5,25,23,2,92,0,3,3,0,100,2.9,970,53
thats_the_way_i_like_it,5.7,15,7,8,46,0,4,2,2,50,3.5,291,72
virtual_sexuality,0,4,1,3,25,0,0,0,0,0,0,0,0
10005403-the_baxter,5.1,73,24,49,32,4.8,24,6,18,25,3.7,1793,76
corduroy-and-more-stories-about-friendship,0,0,0,0,0,0,0,0,0,0,0,0,0
the-scent-of-green-papaya,8.1,14,14,0,100,0,2,2,0,100,4,1483,82
pierrot-le-fou-pierrot-goes-wild-crazy-pete,7.8,34,28,6,82,0,4,2,2,50,4.2,3601,88
weekend_at_bernies,4.9,21,10,11,47,0,1,0,1,0,3,6596,57
strange_cargo,7,8,5,3,62,0,0,0,0,0,0,0,0
seven_girlfriends,5.7,6,3,3,50,0,0,0,0,0,0,0,0
tuesdays_with_morrie,5.3,6,4,2,66,0,0,0,0,0,0,0,0
aleksandr-nevskiy-alexander-nevsky,8.7,16,15,1,93,0,3,2,1,66,4,1217,82
1010939-jason_and_the_argonauts,7.7,23,22,1,95,0,0,0,0,0,0,0,0
same-old-song,6.4,14,9,5,64,0,2,1,1,50,3.8,499,77
soft_skin,7.4,11,10,1,90,0,2,1,1,50,3.9,573,85
wintersleepers,0,0,0,0,0,0,0,0,0,0,0,0,0
driller_killer,6,10,7,3,70,0,0,0,0,0,0,0,0
throne_of_blood,8.7,33,32,1,96,0,3,3,0,100,4.3,5573,93
best_of_youth,8.4,62,59,3,95,8.1,26,24,2,92,4.6,2911,97
guncrazy,5.8,8,5,3,62,0,1,0,1,0,2.9,869,38
bang_rajan,6.2,31,22,9,70,5.8,13,8,5,61,3.4,846,66
1021966-treasure_island,0,0,0,0,0,0,0,0,0,0,0,0,0
zorba_the_greek,7.2,5,4,1,80,0,0,0,0,0,0,0,0
1099778-undercurrent,0,3,2,1,66,0,0,0,0,0,0,0,0
bang_bang_youre_dead,0,2,1,1,50,0,0,0,0,0,0,0,0
my_side_of_the_mountain,0,3,2,1,66,0,1,1,0,100,3.2,556,47
thin_blue_line,8.7,11,11,0,100,0,1,1,0,100,4,1805,89
1071167-twister,6,49,28,21,57,6.7,10,7,3,70,3.2,45771,62
1042281-sniper,4.7,12,5,7,41,0,2,1,1,50,3,3468,58
dont_tell_anyone,0,1,1,0,100,0,0,0,0,0,0,0,0
ghost_in_the_machine,3,8,1,7,12,0,1,0,1,0,2.6,1353,32
time_for_drunken_horses,7.3,30,25,5,83,8.1,7,7,0,100,4.3,467,91
genghis_blues,7.1,11,8,3,72,0,3,3,0,100,4,354,88
john_rambo,4.8,138,50,88,36,4,26,6,20,23,3.4,107524,70
september_11,6.6,58,45,13,77,6.6,21,16,5,76,3.5,303,62
bon-voyage-charlie-brown-and-dont-come-back,0,0,0,0,0,0,0,0,0,0,0,0,0
internal_affairs,6.7,25,22,3,88,6.9,7,6,1,85,3.2,1646,56
parallax_view,7.7,26,24,2,92,0,4,2,2,50,3.7,1119,77
1023205-warriors,7.4,30,28,2,93,0,0,0,0,0,0,0,0
1068449-mayerling,0,3,1,2,33,0,1,0,1,0,3,76,38
in-the-shadow-of-babylon,0,0,0,0,0,0,0,0,0,0,0,0,0
babylon-5-the-river-of-souls,0,0,0,0,0,0,0,0,0,0,0,0,0
babylon-5-thirdspace,0,0,0,0,0,0,0,0,0,0,0,0,0
fm,0,4,2,2,50,0,0,0,0,0,0,0,0
waterloo,0,2,2,0,100,0,0,0,0,0,0,0,0
dreamer,6.3,115,73,42,63,6.1,29,17,12,58,3.6,21404,74
north_beach,0,2,1,1,50,0,0,0,0,0,0,0,0
zardoz,5.2,18,8,10,44,0,1,0,1,0,3.1,2696,51
school_for_scoundrels,4.6,137,35,102,25,4.5,32,8,24,25,3.2,39981,57
virgin_spring,8.1,16,15,1,93,0,2,1,1,50,4.2,2857,92
icecold-in-alex-desert-attack,0,0,0,0,0,0,0,0,0,0,0,0,0
mogambo,6.2,9,7,2,77,0,0,0,0,0,0,0,0
1119827-second_skin,0,0,0,0,0,0,0,0,0,0,0,0,0
secret_life_of_walter_mitty,7,5,4,1,80,0,0,0,0,0,0,0,0
cypher,6.3,17,10,7,58,0,0,0,0,0,0,0,0
the-rack,0,0,0,0,0,0,0,0,0,0,0,0,0
another_thin_man,7.1,12,12,0,100,0,0,0,0,0,0,0,0
thin_man_goes_home,6.4,5,3,2,60,0,0,0,0,0,0,0,0
shadow_of_the_thin_man,6.8,6,5,1,83,0,0,0,0,0,0,0,0
after_the_thin_man,7.5,12,12,0,100,0,0,0,0,0,0,0,0
song_of_the_thin_man,6,10,8,2,80,0,0,0,0,0,0,0,0
woodstock,8.6,19,19,0,100,0,2,2,0,100,4.1,2814,90
36_fillette,7.1,7,6,1,85,0,1,1,0,100,3,414,48
internecine_project,0,0,0,0,0,0,0,0,0,0,0,0,0
10007792-crazy_love,7,84,65,19,77,7,32,26,6,81,3.6,2624,70
gunga_din,8,24,22,2,91,0,1,1,0,100,3.7,1406,74
1006364-dune,6.1,26,16,10,61,0,2,0,2,0,3.4,17715,67
lammbock,0,0,0,0,0,0,0,0,0,0,0,0,0
1076222-legend,7.2,9,8,1,88,0,0,0,0,0,0,0,0
tremors_2_aftershocks,5.3,8,5,3,62,0,0,0,0,0,0,0,0
tremors_3_back_to_perfection,5.5,6,4,2,66,0,0,0,0,0,0,0,0
peanut_butter_solution,0,0,0,0,0,0,0,0,0,0,0,0,0
getting_it_right,6,6,4,2,66,0,1,1,0,100,3.9,146,73
straight_to_hell,4.2,7,2,5,28,0,1,0,1,0,3.3,813,54
friday_night,6.9,53,42,11,79,6.2,16,12,4,75,3.4,267,55
white_zombie,6.9,13,10,3,76,0,0,0,0,0,0,0,0
i_walked_with_a_zombie,7.7,22,20,2,90,0,3,1,2,33,3.7,1271,73
highway_61,6.8,5,5,0,100,0,1,1,0,100,0,0,0
vampire_lovers,4.9,7,3,4,42,0,2,1,1,50,3.4,584,62
countess_dracula,0,2,0,2,0,0,0,0,0,0,0,0,0
but_im_a_cheerleader,4.7,46,15,31,32,4.1,12,3,9,25,3.4,7081,74
how_to_succeed_in_business_without_really_trying,7,9,8,1,88,0,0,0,0,0,0,0,0
pat_garrett_and_billy_the_kid,7.2,17,14,3,82,0,3,1,2,33,3.8,2126,82
the-left-handed-gun,7.8,7,7,0,100,0,2,2,0,100,3.4,241,52
1050388-last_man_on_earth,6.3,15,11,4,73,0,1,0,1,0,3.6,4886,69
street_fighter,0,4,3,1,75,0,0,0,0,0,0,0,0
return_of_the_street_fighter,0,3,0,3,0,0,0,0,0,0,0,0,0
fistful_of_dynamite,7.5,19,17,2,89,7.5,5,4,1,80,3.8,4524,77
bring_me_the_head_of_alfredo_garcia,7.3,18,15,3,83,0,2,1,1,50,3.9,2407,84
ride_the_high_country,8.2,14,13,1,92,0,1,1,0,100,0,0,0
ballad_of_cable_hogue,7,13,12,1,92,0,3,3,0,100,3.6,929,75
junior_bonner,7.4,17,15,2,88,0,3,2,1,66,3.4,748,60
master_of_the_flying_guillotine,6.9,20,18,2,90,0,4,4,0,100,3.9,1371,83
frankenstein_must_be_destroyed,0,2,0,2,0,0,0,0,0,0,0,0,0
haunted_palace,0,4,3,1,75,0,0,0,0,0,0,0,0
finders_fee,6.8,5,3,2,60,0,0,0,0,0,0,0,0
whip_and_the_body,6.8,7,5,2,71,0,0,0,0,0,0,0,0
berlin-symphony-of-a-great-city,6.4,6,5,1,83,0,1,1,0,100,3.9,403,81
samurai-fiction,0,1,1,0,100,0,0,0,0,0,0,0,0
gidget,5.6,8,4,4,50,0,0,0,0,0,0,0,0
wild-in-the-streets1968,6,8,5,3,62,0,1,0,1,0,3.6,252,69
indian_runner,5.9,13,9,4,69,0,2,2,0,100,3.7,1580,78
drunken_angel,7.5,13,13,0,100,0,3,3,0,100,4,1199,87
desperate_living,6,10,7,3,70,0,0,0,0,0,0,0,0
devils_rain,3.9,10,2,8,20,0,1,0,1,0,0,0,0
valachi_papers,0,0,0,0,0,0,0,0,0,0,0,0,0
1017818-rolling_thunder,6.9,5,5,0,100,0,0,0,0,0,0,0,0
1020312-stray_dog,7.4,15,14,1,93,0,0,0,0,0,0,0,0
1009583-hidden_fortress,8.6,22,22,0,100,0,2,2,0,100,4.1,6021,90
high_and_low,7.8,14,13,1,92,0,2,2,0,100,4.3,2474,94
after_the_rehearsal,7.7,10,9,1,90,0,3,3,0,100,3.7,244,69
people_under_the_stairs,5.5,13,8,5,61,0,1,0,1,0,3.1,6410,60
my_new_gun,5.7,6,3,3,50,0,1,0,1,0,3.4,190,40
dark_days,7.8,29,27,2,93,7.4,5,4,1,80,4,1419,89
night_in_casablanca,5,7,4,3,57,0,0,0,0,0,0,0,0
zelig,7.7,17,17,0,100,0,0,0,0,0,0,0,0
1070856-face_to_face,6.8,7,5,2,71,0,4,2,2,50,4,333,86
shame,6.8,14,10,4,71,0,3,2,1,66,4,1110,88
1018974-silence,8,12,11,1,91,0,3,2,1,66,4.1,1976,89
winter_light,7.7,15,12,3,80,0,3,2,1,66,4.3,1967,92
through_a_glass_darkly,8.6,14,14,0,100,0,2,2,0,100,4.2,2486,91
smiles_of_a_summer_night,8.5,10,10,0,100,0,1,1,0,100,4,1688,88
natural_born_killers,6,29,15,14,51,5.9,7,3,4,42,3.5,39062,80
night_of_the_iguana,7.2,14,10,4,71,0,3,1,2,33,3.9,1177,84
freud_the_secret_passion,0,1,1,0,100,0,0,0,0,0,0,0,0
reflections_in_a_golden_eye,6.6,6,5,1,83,0,0,0,0,0,0,0,0
under_the_volcano,6.5,16,12,4,75,0,4,3,1,75,3.6,510,71
wise_blood,7.4,9,8,1,88,0,0,0,0,0,0,0,0
yakuza,5.8,10,5,5,50,0,3,0,3,0,3.8,480,79
nightbreed,4.9,11,4,7,36,0,1,0,1,0,3.3,3698,62
bottle_shock,5.6,116,56,60,48,6.1,29,16,13,55,3.3,4827,60
rabid_dogs,6,7,5,2,71,0,0,0,0,0,0,0,0
baron_blood,4.1,6,0,6,0,0,2,0,2,0,3.1,382,42
bloody_mama,4.5,6,2,4,33,0,0,0,0,0,0,0,0
1097259-road_trip,5.9,89,52,37,58,5.9,21,14,7,66,3.3,57286,68
1173608-ken_park,4.9,14,6,8,42,0,1,0,1,0,3.3,3212,58
monterey_pop,7.9,16,16,0,100,0,2,2,0,100,4.1,573,88
bridge_too_far,6.6,12,8,4,66,0,0,0,0,0,0,0,0
infernal_affairs,7.6,60,57,3,95,8,22,22,0,100,4.2,19748,94
1143939-1143939-tale_of_two_sisters,7.1,53,46,7,86,6.7,16,13,3,81,3.9,7458,83
broadway_danny_rose,8.1,25,25,0,100,0,4,4,0,100,3.7,2721,78
they_came_from_beyond_space,0,1,0,1,0,0,0,0,0,0,0,0,0
wonderful_ice_cream_suit,0,4,3,1,75,0,0,0,0,0,0,0,0
robot-jox,0,1,0,1,0,0,0,0,0,0,0,0,0
dolls2002,6.7,36,27,9,75,6.9,13,12,1,92,4.2,3709,87
space_truckers,3.4,11,1,10,9,0,0,0,0,0,0,0,0
not-of-this-earth,0,0,0,0,0,0,0,0,0,0,0,0,0
1017745-rock_n_roll_high_school,6.7,23,18,5,78,0,2,1,1,50,3.5,3278,71
death_race,4.8,145,60,85,41,5.2,23,10,13,43,3.5,50505,69
1195241-born_to_kill,0,0,0,0,0,0,0,0,0,0,0,0,0
bucket_of_blood,6.6,10,7,3,70,0,0,0,0,0,0,0,0
premature_burial,4.6,5,2,3,40,0,0,0,0,0,0,0,0
wild_angels,5.5,9,5,4,55,0,0,0,0,0,0,0,0
bedlam,6.5,15,13,2,86,0,2,2,0,100,3.3,649,56
planet_of_the_vampires,5.9,7,4,3,57,0,0,0,0,0,0,0,0
pure_country,0,4,0,4,0,0,1,0,1,0,3.9,3532,89
brigadoon,6,10,8,2,80,0,0,0,0,0,0,0,0
marjorie_morningstar,0,0,0,0,0,0,0,0,0,0,0,0,0
power_of_one,5.6,11,6,5,54,0,2,0,2,0,4,2912,88
weather_underground,7.8,57,52,5,91,7.5,19,16,3,84,3.9,920,85
kikujiro-no-natsu,0,0,0,0,0,0,0,0,0,0,0,0,0
im_with_lucy,0,2,0,2,0,0,0,0,0,0,0,0,0
spring-summer-fall-winter-and-spring,8.1,94,89,5,94,8.1,26,24,2,92,4.2,7663,92
phantom_tollbooth,0,3,3,0,100,0,0,0,0,0,0,0,0
a_perfect_getaway,5.8,124,76,48,61,5.9,29,18,11,62,3.2,102622,50
10_rillington_place,6.5,8,5,3,62,0,1,1,0,100,3.9,564,87
10002114-dark_water,6.8,13,10,3,76,0,0,0,0,0,0,0,0
thing_called_love,5.3,20,11,9,55,0,4,2,2,50,3.5,2915,71
vor-the-thief,7,24,21,3,87,7.6,9,9,0,100,4,254,89
how_to_steal_a_million,7,6,6,0,100,0,0,0,0,0,0,0,0
stendhal_syndrome,6.2,11,8,3,72,0,0,0,0,0,0,0,0
dangan-ranna-dangan-runner-nonstop,0,0,0,0,0,0,0,0,0,0,0,0,0
support_your_local_sheriff,6,11,7,4,63,0,1,0,1,0,3.6,1267,77
brain_donors,4.8,9,4,5,44,0,0,0,0,0,0,0,0
passed_away,4.5,8,1,7,12,0,2,0,2,0,0,0,0
mean_streets,8.9,46,45,1,97,9.2,6,6,0,100,3.8,15074,83
jack_the_bear,4.9,17,5,12,29,0,2,1,1,50,3.2,989,56
i_am_a_fugitive_from_a_chain_gang,8.4,16,16,0,100,0,0,0,0,0,0,0,0
hamburger_hill,7.3,11,11,0,100,0,3,3,0,100,3.4,6794,68
harper,7.1,16,16,0,100,0,3,3,0,100,3.6,474,69
1020684-sweet_bird_of_youth,6.7,16,12,4,75,0,3,1,2,33,3.7,457,71
dahmer,6.4,38,26,12,68,5.9,9,5,4,55,2.8,1473,41
1015925-paradise,0,3,0,3,0,0,0,0,0,0,0,0,0
halbe-treppe-grill-point,0,0,0,0,0,0,0,0,0,0,0,0,0
frankenstein_unbound,5,15,6,9,40,0,1,1,0,100,2.9,443,37
shiri2002,5.5,36,21,15,58,6.1,12,8,4,66,3.6,1502,70
bad_day_at_black_rock,8.2,25,24,1,96,0,3,2,1,66,3.9,1420,86
i-kina-spiser-de-hunde-in-china-they-eat-dogs,0,0,0,0,0,0,0,0,0,0,0,0,0
delta_force_2,2.2,7,0,7,0,0,1,0,1,0,2.9,1781,45
1112549-crossroads,3.9,101,14,87,13,3.9,24,3,21,12,2.2,15071,41
29th_street,6.4,9,7,2,77,0,2,2,0,100,3.3,877,67
la-grande-seduction-seducing-doctor-lewis,6.3,65,44,21,67,5.9,19,12,7,63,3.9,1308,87
rip-it-off,0,0,0,0,0,0,0,0,0,0,0,0,0
sammy_and_rosie_get_laid,6.9,8,7,1,87,0,1,1,0,100,3.8,157,74
leaving_normal,4.6,7,2,5,28,0,2,0,2,0,0,0,0
sunrise,8.8,38,37,1,97,7.7,8,7,1,87,4.4,2918,93
shock_corridor,7.6,11,10,1,90,0,0,0,0,0,0,0,0
first_20_million_is_always_the_hardest,2.4,9,1,8,11,0,2,0,2,0,3.2,483,50
au_revoir_les_enfants,9.2,23,22,1,95,10,5,4,1,80,4.2,3681,92
sex_the_annabel_chong_story,5.1,17,7,10,41,0,4,2,2,50,3.1,1360,51
1130343-girl_next_door,5.6,156,87,69,55,5,32,17,15,53,3.3,39311,71
pursuit_of_happyness,6.4,166,110,56,66,6.1,38,25,13,65,4.1,211913,88
gladiator,7,159,123,36,77,6.4,36,26,10,72,3.8,248672,85
1144585-inheritance,6.7,36,27,9,75,6.1,15,9,6,60,3.8,493,79
sky_blue,5.6,42,23,19,54,5.4,16,8,8,50,3.6,1432,73
indestructible_man,0,0,0,0,0,0,0,0,0,0,0,0,0
1034011-wasp_woman,4.3,10,4,6,40,0,0,0,0,0,0,0,0
leeches,0,0,0,0,0,0,0,0,0,0,0,0,0
1032796-deranged,0,4,1,3,25,0,0,0,0,0,0,0,0
cruel_sea,0,2,2,0,100,0,0,0,0,0,0,0,0
elvis-is-alive,0,0,0,0,0,0,0,0,0,0,0,0,0
lola_montes,7.8,27,23,4,85,7.3,10,8,2,80,3.8,488,78
fly-thought-on-golden-wings,0,0,0,0,0,0,0,0,0,0,0,0,0
twice_upon_a_time,0,1,1,0,100,0,0,0,0,0,0,0,0
1042327-atlantis_the_lost_continent,0,4,0,4,0,0,0,0,0,0,0,0,0
1012920-lust_for_life,7.8,9,9,0,100,0,0,0,0,0,0,0,0
dolce_vita,9.1,53,52,1,98,8.5,15,14,1,93,0,0,0
jinroh-the-wolf-brigade,5.8,22,12,10,54,5.4,7,4,3,57,3.7,3049,77
august_rush,4.8,120,44,76,36,4.4,27,7,20,25,4,105941,84
de-lift-the-lift-goin-up,0,0,0,0,0,0,0,0,0,0,0,0,0
batteries_not_included,5.6,13,8,5,61,0,2,2,0,100,3.2,9550,61
educating_rita,7.2,13,11,2,84,0,1,0,1,0,3.6,1843,77
on_moonlight_bay,6.2,5,5,0,100,0,0,0,0,0,0,0,0
sansho_the_bailiff,9.1,10,10,0,100,0,0,0,0,0,0,0,0
zazie-dans-le-metro-zazie-in-the-subway,0,0,0,0,0,0,0,0,0,0,0,0,0
americanization_of_emily,7.4,11,11,0,100,0,0,0,0,0,0,0,0
anne_of_the_thousand_days,0,4,3,1,75,0,0,0,0,0,0,0,0
baby_doll,8,14,14,0,100,0,3,3,0,100,3.9,746,81
lavventura,8.6,26,25,1,96,0,3,3,0,100,4.2,3223,90
beyond_the_valley_of_the_dolls,6.1,22,15,7,68,0,3,1,2,33,0,0,0
hiroshima_mon_amour,8.4,18,17,1,94,0,2,2,0,100,4.2,3402,89
1000_eyes_of_dr_mabuse,6.8,7,6,1,85,0,0,0,0,0,0,0,0
ugetsu,8.9,19,19,0,100,8.4,5,5,0,100,4.3,1896,93
at_play_in_the_fields_of_the_lord,5.7,6,3,3,50,0,1,1,0,100,0,0,0
golden_coach,8.3,11,11,0,100,0,2,2,0,100,3.9,335,83
la_guerre_est_finie,8.2,7,7,0,100,0,3,3,0,100,3.8,194,72
mystery_of_the_wax_museum,7.4,8,8,0,100,0,0,0,0,0,0,0,0
day_of_the_jackal,7.6,20,18,2,90,0,4,3,1,75,3.9,2316,86
1017238-razors_edge,5.4,15,8,7,53,0,1,0,1,0,3.7,879,77
nightmare_city,0,4,2,2,50,0,0,0,0,0,0,0,0
war_of_the_buttons,0,2,2,0,100,0,0,0,0,0,0,0,0
1015710-other,6.8,7,6,1,85,0,1,1,0,100,3.7,411,72
1015052-night_of_the_living_dead,8.5,45,43,2,95,7,5,4,1,80,3.7,26113,85
drums_along_the_mohawk,6.7,9,7,2,77,0,0,0,0,0,0,0,0
1013139-maltese_falcon,9,40,40,0,100,8.2,6,6,0,100,4,14452,90
i_love_you_again,0,4,4,0,100,0,0,0,0,0,0,0,0
safety_last,8.5,12,11,1,91,0,0,0,0,0,0,0,0
while_the_city_sleeps,8.9,7,7,0,100,0,0,0,0,0,0,0,0
little_murders,6.4,7,4,3,57,0,1,1,0,100,3.7,356,77
viridiana,8.9,19,19,0,100,0,2,2,0,100,4.2,2048,90
totally_fed_up,7.6,6,6,0,100,0,0,0,0,0,0,0,0
megamind,0,0,0,0,0,0,0,0,0,0,0,0,0
youre_a_big_boy_now,6.4,9,7,2,77,0,3,3,0,100,3.3,183,46
lupin_the_3rd_castle_of_cagliostro,7,10,9,1,90,0,1,1,0,100,4,4187,86
1121013-chaos,6.5,16,11,5,68,5.8,5,3,2,60,3.3,372,56
queen_christina,8.3,12,12,0,100,0,0,0,0,0,0,0,0
1001816-battleground,8.4,5,5,0,100,0,0,0,0,0,0,0,0
toxic_avenger_iv_citizen_toxie,5.9,9,6,3,66,0,2,1,1,50,3.3,1527,63
1021112-texas_chainsaw_massacre,7.7,40,36,4,90,0,3,2,1,66,3.4,22149,78
crazy_stranger,7,21,17,4,80,7.5,6,6,0,100,4.1,1215,88
3_women,7.9,20,19,1,95,7.1,5,4,1,80,3.9,1570,85
green_pastures,6.6,7,6,1,85,0,0,0,0,0,0,0,0
take_me_out_to_the_ballgame,7.5,6,6,0,100,0,0,0,0,0,0,0,0
grey-gardens1975,8.4,16,16,0,100,0,4,4,0,100,4.1,2464,87
1043368-frog_prince,0,0,0,0,0,0,0,0,0,0,0,0,0
purple_rain,6.3,29,22,7,75,0,2,1,1,50,3.3,7627,78
1062610-signs_of_life,7.1,8,7,1,87,0,1,0,1,0,3.6,399,67
1042629-point_of_no_return,5.4,21,10,11,47,0,3,2,1,66,2.9,3771,51
short_time,4.6,5,1,4,20,0,1,0,1,0,3.6,119,65
hairdressers_husband,8.1,10,10,0,100,0,0,0,0,0,0,0,0
cromwell,0,4,1,3,25,0,1,0,1,0,3.4,463,60
jamon_jamon,7,10,8,2,80,0,2,1,1,50,3.5,1911,65
1191620-college,2.5,40,2,38,5,2.8,12,1,11,8,2.8,10667,35
mitchell,0,0,0,0,0,0,0,0,0,0,0,0,0
1045403-ten_little_indians,0,1,0,1,0,0,0,0,0,0,0,0,0
Hakuchi,7,7,6,1,85,0,0,0,0,0,0,0,0
used_people,5.2,12,5,7,41,0,2,0,2,0,3.1,89,30
trumpet_of_the_swan,3.4,40,5,35,12,3.2,15,1,14,6,2.9,930,39
most_dangerous_game,7.7,13,13,0,100,0,0,0,0,0,0,0,0
1037105-front_page,5.8,24,16,8,66,0,1,1,0,100,3.6,905,73
dolls2002,6.7,36,27,9,75,6.9,13,12,1,92,4.2,3709,87
1205903-our_man_in_havana,7.7,5,5,0,100,0,0,0,0,0,0,0,0
1013201-man_who_came_to_dinner,8,5,4,1,80,0,1,1,0,100,3.9,562,81
bloody_sunday,7.9,102,94,8,92,8.2,30,28,2,93,4,2812,89
midnight_cowboy,8.3,49,44,5,89,6.8,6,5,1,83,3.9,8994,87
major_and_the_minor,7.5,14,14,0,100,0,3,3,0,100,4,562,85
caine_mutiny,7.8,23,21,2,91,0,3,2,1,66,3.8,1792,85
black_narcissus,8.7,23,23,0,100,0,3,3,0,100,4.1,1865,88
escape_from_alcatraz,7,17,16,1,94,0,1,1,0,100,3.6,14313,78
charles-dickens-the-man-who-asked-for-more,0,0,0,0,0,0,0,0,0,0,0,0,0
shrek_2,7.6,210,186,24,88,7.3,40,35,5,87,3.5,228151,69
day_after_tomorrow,5.3,208,95,113,45,5.2,42,18,24,42,3.2,174938,57
raising_helen,4.6,126,28,98,22,4.7,35,6,29,17,3.2,23535,65
soul_plane,3.6,97,18,79,18,3.9,27,4,23,14,2.8,10665,61
baadasssss,7.4,106,96,10,90,7.5,32,29,3,90,3.6,960,81
1132642-mother,7,88,68,20,77,7.4,32,29,3,90,3.4,862,61
saved,6.1,140,85,55,60,5.8,37,20,17,54,3.4,19848,75
1132644-time_of_the_wolf,6.2,53,33,20,62,6.5,16,12,4,75,3.5,1297,67
chicken-shack-id-rather-go-live,0,0,0,0,0,0,0,0,0,0,0,0,0
mindhunters,4.3,114,29,85,25,3.6,32,2,30,6,3.2,6070,61
1217686-zatoichi,7.2,113,98,15,86,7.4,29,27,2,93,3.9,10635,86
chronicles_of_riddick,4.6,158,46,112,29,4,33,4,29,12,3.3,35951,73
garfield,3.5,133,19,114,14,3.5,33,4,29,12,2.9,33314,54
stepford_wives,4.7,163,43,120,26,4.9,37,11,26,29,2.6,14476,36
bright_future,6.6,20,14,6,70,5.3,7,3,4,42,3.6,823,70
hunting_of_the_president,6.3,57,42,15,73,5.9,23,14,9,60,3.2,449,51
napoleon_dynamite,6.3,162,114,48,70,5.8,35,23,12,65,3.3,106996,73
city_of_joy,5,14,8,6,57,0,2,2,0,100,3.4,1490,70
doctor-who,0,0,0,0,0,0,0,0,0,0,0,0,0
dresser,8.1,13,13,0,100,0,1,1,0,100,3.8,466,80
father_hood,2.3,8,0,8,0,0,2,0,2,0,2.7,1547,35
for_me_and_my_gal,7.6,7,7,0,100,0,0,0,0,0,0,0,0
hello_again,3.6,18,2,16,11,0,4,0,4,0,2.7,630,47
hope_springs,4.5,12,3,9,25,0,1,1,0,100,2.8,1628,31
love-finds-andy-hardy,0,0,0,0,0,0,0,0,0,0,0,0,0
lover_come_back,6.4,8,7,1,87,0,0,0,0,0,0,0,0
police_academy_7_mission_to_moscow,0,3,0,3,0,0,0,0,0,0,0,0,0
ring_of_bright_water,7.1,5,5,0,100,0,0,0,0,0,0,0,0
big_wednesday,5.9,7,4,3,57,0,0,0,0,0,0,0,0
fool_for_love,5.5,11,8,3,72,0,3,2,1,66,3,339,37
give_my_regards_to_broad_street,4,13,3,10,23,0,3,0,3,0,2.8,184,32
last_of_sheila,7.3,11,10,1,90,0,1,1,0,100,3.8,402,77
10010760-miss_march,2.5,76,4,72,5,2.4,14,0,14,0,2.7,39534,34
major_movie_star,0,2,0,2,0,0,0,0,0,0,0,0,0
were_not_married,0,2,1,1,50,0,0,0,0,0,0,0,0
wish-you-were-here-cruel-summer,0,0,0,0,0,0,0,0,0,0,0,0,0
adventures_of_sherlock_holmes,7.9,7,7,0,100,0,0,0,0,0,0,0,0
book_of_love,0,4,1,3,25,0,0,0,0,0,0,0,0
1070230-helen_of_troy,0,2,2,0,100,0,0,0,0,0,0,0,0
1010004-hound_of_the_baskervilles,7.8,11,11,0,100,0,0,0,0,0,0,0,0
hour_of_the_wolf,7.5,16,14,2,87,0,3,2,1,66,3.9,1979,85
molly_maguires,6.6,9,8,1,88,0,2,1,1,50,3.4,501,57
1020415-suddenly,6.4,7,6,1,85,0,1,1,0,100,3.3,506,59
urban_ghost_story,0,4,4,0,100,0,0,0,0,0,0,0,0
dying_of_laughter,0,0,0,0,0,0,0,0,0,0,0,0,0
kings_row,7.6,13,13,0,100,0,0,0,0,0,0,0,0
10003356-kid_brother,0,3,3,0,100,0,0,0,0,0,0,0,0
gay_divorcee,7.8,8,8,0,100,0,0,0,0,0,0,0,0
applegates,4.4,9,1,8,11,0,1,0,1,0,0,0,0
robotto-kanibaru-robot-carnival,0,0,0,0,0,0,0,0,0,0,0,0,0
americathon_1998,0,0,0,0,0,0,0,0,0,0,0,0,0
sands_of_iwo_jima,7.4,10,10,0,100,0,0,0,0,0,0,0,0
this_island_earth,5,11,7,4,63,0,0,0,0,0,0,0,0
anthony_adverse,0,2,0,2,0,0,0,0,0,0,0,0,0
blackboard_jungle,7.1,21,16,5,76,0,3,2,1,66,3.5,811,72
moment-by-moment,0,0,0,0,0,0,0,0,0,0,0,0,0
it-had-to-be-you-1947,0,0,0,0,0,0,0,0,0,0,0,0,0
luna-papa-moon-father,0,0,0,0,0,0,0,0,0,0,0,0,0
raising_victor_vargas,7.9,105,101,4,96,8,31,31,0,100,3.8,1155,81
investigation_of_a_citizen_above_suspicion,7.9,5,5,0,100,0,3,3,0,100,4.4,483,97
1022079-true_love,6.2,8,6,2,75,0,1,1,0,100,3.2,207,50
chacun-son-cinema-to-each-his-cinema,6.8,5,5,0,100,0,2,2,0,100,3.6,664,72
heiress,8.6,7,7,0,100,0,0,0,0,0,0,0,0
1029261-state_fair,6.4,5,4,1,80,0,0,0,0,0,0,0,0
dragon_seed,0,3,2,1,66,0,0,0,0,0,0,0,0
executive_suite,8,7,7,0,100,0,0,0,0,0,0,0,0
1011176-johnny_belinda,7.1,7,6,1,85,0,0,0,0,0,0,0,0
food-and-culture,0,0,0,0,0,0,0,0,0,0,0,0,0
johnny_eager,0,2,1,1,50,0,1,1,0,100,3.7,182,73
la_jetee,8.4,21,19,2,90,0,3,2,1,66,4.4,3059,93
distant_voices_still_lives,7.9,15,13,2,86,0,1,1,0,100,4.2,292,87
1011626-king_of_kings,6.2,14,11,3,78,0,4,2,2,50,3.7,879,75
northwest_passage,8.8,6,6,0,100,0,0,0,0,0,0,0,0
1016302-picture_of_dorian_gray,7.9,9,8,1,88,0,0,0,0,0,0,0,0
born_losers,5.8,5,3,2,60,0,0,0,0,0,0,0,0
human_condition,7.3,8,7,1,87,0,3,2,1,66,4.4,321,94
10002103-samsara,7.3,5,5,0,100,0,3,3,0,100,4.1,3198,85
bachelor_mother,0,4,3,1,75,0,0,0,0,0,0,0,0
please_dont_eat_the_daisies,5.5,6,4,2,66,0,0,0,0,0,0,0,0
siddhartha,6.7,17,10,7,58,6.4,7,4,3,57,3.3,225,57
white_heat,8.4,28,28,0,100,0,4,4,0,100,4.2,2557,93
1004126-christmas_carol,7.7,23,19,4,82,0,3,2,1,66,3.3,4980,71
1031087-memphis_belle,6,15,11,4,73,0,2,2,0,100,3.4,3799,75
cincinnati_kid,7.7,16,14,2,87,0,2,1,1,50,3.6,1393,77
animal_factory,6.7,32,26,6,81,6.7,5,4,1,80,3.2,2952,55
1156599-panic_in_needle_park,7,9,7,2,77,0,1,1,0,100,3.6,1885,74
pretty_baby,6.9,14,11,3,78,0,0,0,0,0,0,0,0
hitcher,3.8,93,19,74,20,3.5,16,2,14,12,3.1,49309,59
1018915-show_boat,9.4,8,8,0,100,0,0,0,0,0,0,0,0
1010824-ivanhoe,5.6,10,7,3,70,0,0,0,0,0,0,0,0
box_of_moonlight,6.7,16,9,7,56,5.8,5,1,4,20,3.9,803,83
eel,7,25,19,6,76,6.7,6,5,1,83,3.8,686,81
fear_x,5.8,32,18,14,56,6.3,7,5,2,71,2.7,512,30
freaks,8.3,41,39,2,95,0,3,3,0,100,4,6354,87
immigrant,0,0,0,0,0,0,0,0,0,0,0,0,0
silent_movie,7.1,19,17,2,89,0,1,1,0,100,3.4,3857,65
1077183-stairway_to_heaven,8.7,17,17,0,100,0,1,1,0,100,4.4,2083,94
1001060-anna_christie,0,1,1,0,100,0,0,0,0,0,0,0,0
bat_people,0,0,0,0,0,0,0,0,0,0,0,0,0
1039270-deep_cover,6.6,20,17,3,85,5.8,8,6,2,75,3.4,1559,70
dr_jekyll_and_mr_hyde,0,1,0,1,0,0,0,0,0,0,0,0,0
my_little_chickadee,7.4,10,9,1,90,0,0,0,0,0,0,0,0
high_and_the_mighty,5.6,8,3,5,37,0,0,0,0,0,0,0,0
ugly_dachshund,0,3,2,1,66,0,0,0,0,0,0,0,0
around_the_world_in_80_days,4.8,127,39,88,30,4.7,33,9,24,27,2.7,14038,45
ill_sleep_when_im_dead,5.5,86,37,49,43,5.9,27,14,13,51,2.9,2107,38
dodgeball_a_true_underdog_story,6.3,159,111,48,69,6.3,36,23,13,63,3.4,118948,75
1133499-1133499-terminal,6.2,198,119,79,60,5.8,43,22,21,51,3.4,42895,72
dear_frankie,6.8,109,88,21,80,6.8,32,26,6,81,4,6479,90
white_chicks,3.7,122,18,104,14,4.6,33,10,23,30,3,193197,62
door_in_the_floor,6.4,140,92,48,65,6.2,38,22,16,57,3.3,2273,63
brian-eno14-video-paintings,0,0,0,0,0,0,0,0,0,0,0,0,0
two_brothers,6.6,112,87,25,77,6.2,32,25,7,78,3.4,4817,74
delovely,5.7,153,74,79,48,5.2,40,17,23,42,3.3,2857,63
kaena_the_prophecy,3.9,30,2,28,6,3.8,12,0,12,0,2.9,1510,46
back_to_bataan,0,3,2,1,66,0,0,0,0,0,0,0,0
1002651-bloodhounds_of_broadway,0,0,0,0,0,0,0,0,0,0,0,0,0
day_at_the_races,7.8,12,12,0,100,0,0,0,0,0,0,0,0
flying_leathernecks,6.8,7,6,1,85,0,1,1,0,100,3.4,821,62
now_you_see_him_now_you_dont,0,1,0,1,0,0,0,0,0,0,0,0,0
briar-patch-plain-dirty,0,0,0,0,0,0,0,0,0,0,0,0,0
bob_and_carol_and_ted_and_alice,7.4,9,8,1,88,0,1,1,0,100,3.4,516,62
littlest_rebel,5.9,8,7,1,87,0,0,0,0,0,0,0,0
1133634-reconstruction,6.4,37,28,9,75,6.8,13,10,3,76,4.1,1344,86
a-claymation-christmas-celebration,0,0,0,0,0,0,0,0,0,0,0,0,0
happenstance,6,36,23,13,63,6.5,16,12,4,75,3.6,1840,71
kopps,0,3,2,1,66,0,0,0,0,0,0,0,0
comandante,5.6,13,8,5,61,0,1,0,1,0,3.5,658,63
undead_2003,4.3,74,22,52,29,3.2,20,1,19,5,3,4889,48
into-the-woods-1991,0,0,0,0,0,0,0,0,0,0,0,0,0
pirates_of_silicon_valley,6.8,7,6,1,85,0,0,0,0,0,0,0,0
manufacturing_consent_noam_chomsky_and_the_media,8.1,7,7,0,100,0,0,0,0,0,0,0,0
1022172-twelve_oclock_high,8.2,14,14,0,100,0,0,0,0,0,0,0,0
leave_her_to_heaven,8.4,17,17,0,100,7.5,5,5,0,100,3.8,937,81
rapanui,0,0,0,0,0,0,0,0,0,0,0,0,0
roxie_hart,7.1,9,8,1,88,0,0,0,0,0,0,0,0
1126416-mayor_of_the_sunset_strip,7.4,75,65,10,86,7.4,27,25,2,92,3.5,553,67
killing_me_softly,3.4,21,0,21,0,0,2,0,2,0,3,2072,46
talvisota-winter-war,0,0,0,0,0,0,0,0,0,0,0,0,0
philadelphia_experiment,5.1,10,5,5,50,0,0,0,0,0,0,0,0
wheeler_dealers,0,0,0,0,0,0,0,0,0,0,0,0,0
juice,6.3,13,11,2,84,0,2,2,0,100,0,0,0
secret_life_of_girls,0,1,0,1,0,0,0,0,0,0,0,0,0
flimflam_man,6.4,7,5,2,71,0,1,1,0,100,3.8,91,66
revenge_of_the_pink_panther,6.7,16,13,3,81,0,0,0,0,0,0,0,0
whale_rider,7.7,143,129,14,90,7.5,35,30,5,85,3.8,9564,87
1206485-i_am_dina,0,2,1,1,50,0,2,1,1,50,3.7,1055,74
10009334-the_escapist,6.1,42,27,15,64,6,10,6,4,60,3.3,2418,63
angels_with_dirty_faces,8,20,20,0,100,0,0,0,0,0,0,0,0
zero-de-conduite-1932,8.9,12,11,1,91,0,3,2,1,66,0,0,0
1206670-shadows,5.8,15,9,6,60,0,4,2,2,50,3.6,188,61
coming-out,0,0,0,0,0,0,0,0,0,0,0,0,0
taxi,3.4,104,11,93,10,3.8,27,5,22,18,2.8,15669,60
taxi_3,0,1,1,0,100,0,0,0,0,0,0,0,0
pull_my_daisy,0,0,0,0,0,0,0,0,0,0,0,0,0
tokyo_godfathers,7.1,57,51,6,89,7.1,21,19,2,90,4,3789,89
le-boucher,8.6,7,7,0,100,0,1,1,0,100,3.9,689,81
our_hospitality,9.5,17,17,0,100,0,0,0,0,0,0,0,0
1194274-walk_all_over_me,0,4,2,2,50,0,1,0,1,0,3,609,37
farmers_daughter,0,4,4,0,100,0,0,0,0,0,0,0,0
lassie_come_home,7.5,7,6,1,85,0,0,0,0,0,0,0,0
1021507-time_of_your_life,0,0,0,0,0,0,0,0,0,0,0,0,0
overboard,5.1,21,11,10,52,0,3,1,2,33,3.2,9078,70
mask_of_fu_manchu,6.6,7,6,1,85,0,0,0,0,0,0,0,0
by_the_light_of_the_silvery_moon,0,1,1,0,100,0,0,0,0,0,0,0,0
butterfield_8,5.6,12,7,5,58,0,0,0,0,0,0,0,0
johnny_guitar,8.4,23,22,1,95,0,3,2,1,66,4,1015,85
sister_my_sister,5.7,8,4,4,50,0,0,0,0,0,0,0,0
le-angel-exterminador-the-exterminating-angel,8.9,17,16,1,94,0,2,1,1,50,4.3,2257,94
ivans_xtc,6.8,28,21,7,75,7.2,9,7,2,77,3.7,269,71
fahrenheit_911,7.3,224,187,37,83,7.4,45,37,8,82,3.3,22990,69
roxanne,7.3,33,29,4,87,6,6,4,2,66,3,5654,57
freedom-downtime,0,0,0,0,0,0,0,0,0,0,0,0,0
1125396-same_river_twice,6.7,31,21,10,67,6.7,14,10,4,71,3.8,44,67
dr_terrors_house_of_horrors,0,4,4,0,100,0,0,0,0,0,0,0,0
1062111-search_and_destroy,4,8,2,6,25,0,3,1,2,33,3,597,45
book_of_life,7.5,9,8,1,88,0,0,0,0,0,0,0,0
such-a-long-journey,7.4,13,12,1,92,7.4,5,5,0,100,3.4,185,66
maxed-out,7,48,42,6,87,6.6,19,15,4,78,3.1,68987,50
secret_society,5.1,9,3,6,33,0,4,1,3,25,2.8,63,50
last_starfighter,6.2,26,19,7,73,0,1,0,1,0,3.3,6360,65
tank_girl,4.9,33,14,19,42,5.3,9,4,5,44,2.8,7013,61
jungle_holocaust,0,2,1,1,50,0,0,0,0,0,0,0,0
citizen-pinoy-the-basic-questions,0,0,0,0,0,0,0,0,0,0,0,0,0
soul,0,0,0,0,0,0,0,0,0,0,0,0,0
before_sunset,8.3,158,150,8,94,8.4,39,38,1,97,4,20750,90
clearing,5.6,128,56,72,43,5.5,34,16,18,47,2.9,1494,35
1133964-king_arthur,4.9,183,57,126,31,5.2,38,12,26,31,3.2,57867,63
sleepover,3.7,95,14,81,14,3.9,29,5,24,17,3.3,29842,62
another_cinderella_story,0,2,2,0,100,0,0,0,0,0,0,0,0
domain-of-murder,0,0,0,0,0,0,0,0,0,0,0,0,0
maria_full_of_grace,8,137,133,4,97,8.2,34,33,1,97,3.8,9542,84
follow_that_dream,0,2,2,0,100,0,0,0,0,0,0,0,0
girl_of_your_dreams,0,0,0,0,0,0,0,0,0,0,0,0,0
gray_lady_down,6,5,3,2,60,0,0,0,0,0,0,0,0
1012647-long_days_journey_into_night,8.3,13,12,1,92,0,1,1,0,100,3.9,807,82
man-of-la-mancha,5.5,12,6,6,50,0,1,0,1,0,0,0,0
night_of_the_following_day,7.2,5,5,0,100,0,1,1,0,100,3.3,195,44
1043958-posse,5.1,15,5,10,33,0,4,1,3,25,2.8,1087,45
1033462-prince_valiant,0,0,0,0,0,0,0,0,0,0,0,0,0
rustlers_rhapsody,0,4,0,4,0,0,0,0,0,0,0,0,0
short_film_about_killing,7.7,12,10,2,83,0,3,2,1,66,4.2,1659,92
tin_star,0,4,4,0,100,0,0,0,0,0,0,0,0
zandalee,4,6,2,4,33,0,0,0,0,0,0,0,0
brief_crossing,0,2,2,0,100,0,0,0,0,0,0,0,0
deluge,0,0,0,0,0,0,0,0,0,0,0,0,0
how_the_west_was_won,7.1,15,14,1,93,0,0,0,0,0,0,0,0
messenger_the_story_of_joan_of_arc,4.5,72,22,50,30,3.4,21,1,20,4,3.1,8110,57
live_forever,5.6,5,4,1,80,0,0,0,0,0,0,0,0
monsieur-klein-1976,0,0,0,0,0,0,0,0,0,0,0,0,0
bourne_supremacy,7.2,185,150,35,81,7,39,29,10,74,3.9,111547,89
catwoman,3.1,177,17,160,9,3.3,39,4,35,10,2.2,23007,34
home_at_the_end_of_the_world,5.7,111,53,58,47,6.1,32,18,14,56,3.5,3425,66
some_girls,0,1,0,1,0,0,0,0,0,0,0,0,0
stay_hungry,6.5,6,5,1,83,0,1,1,0,100,2.9,807,34
testament_of_dr_mabuse,8.2,10,9,1,90,0,0,0,0,0,0,0,0
zus-zo-hotel-paraiso,4.9,19,8,11,42,4,9,1,8,11,3,136,41
battle_hymn,0,4,1,3,25,0,1,0,1,0,2.9,249,30
1048119-crash_dive,0,3,1,2,33,0,0,0,0,0,0,0,0
disco-pigs,4.8,5,1,4,20,0,0,0,0,0,0,0,0
enemy_below,0,4,3,1,75,0,0,0,0,0,0,0,0
fist-of-the-north-star1995,0,3,2,1,66,0,0,0,0,0,0,0,0
flash-gordon-conquers-the-universe,6.5,7,6,1,85,0,0,0,0,0,0,0,0
guns_of_the_magnificent_seven,0,2,2,0,100,0,0,0,0,0,0,0,0
deer_hunter,8.3,44,40,4,90,7.1,5,4,1,80,4.1,27513,91
in-a-glass-cage,5,6,3,3,50,0,4,2,2,50,3.7,441,77
lancelot_of_the_lake,8.2,12,11,1,91,0,2,1,1,50,3.7,482,71
last_valley,0,2,2,0,100,0,0,0,0,0,0,0,0
magnificent_seven_ride,0,0,0,0,0,0,0,0,0,0,0,0,0
man_escaped,8.5,17,17,0,100,0,1,1,0,100,4.3,1392,92
miracle_of_marcelino,0,0,0,0,0,0,0,0,0,0,0,0,0
morituri,0,3,2,1,66,0,0,0,0,0,0,0,0
orgy_of_the_dead,1.2,5,0,5,0,0,0,0,0,0,0,0,0
shalako,0,4,1,3,25,0,1,0,1,0,2.9,691,34
shock_to_the_system,5,8,4,4,50,4.5,5,2,3,40,2.8,7652,33
slaughterhouse_five,7.4,13,10,3,76,0,0,0,0,0,0,0,0
wake_island,7.4,5,5,0,100,0,0,0,0,0,0,0,0
1023438-what_price_glory,0,4,2,2,50,0,0,0,0,0,0,0,0
you_were_never_lovelier,7.4,5,5,0,100,0,0,0,0,0,0,0,0
bachelor_and_the_bobbysoxer,6.2,8,6,2,75,0,1,0,1,0,3.7,1615,77
breezy,0,2,1,1,50,0,0,0,0,0,0,0,0
la-ciudad-sin-limites,0,0,0,0,0,0,0,0,0,0,0,0,0
comfort_of_strangers,5.7,13,8,5,61,0,2,0,2,0,3.4,597,58
dancing_in_september,0,3,3,0,100,0,0,0,0,0,0,0,0
destination_tokyo,0,4,3,1,75,0,0,0,0,0,0,0,0
dr_jekyll_and_ms_hyde,2.5,7,1,6,14,0,1,0,1,0,2.4,1292,25
1052200-dream_lover,5.6,13,7,6,53,0,2,1,1,50,3,280,40
fausto-50,0,0,0,0,0,0,0,0,0,0,0,0,0
for-queen-and-country,0,0,0,0,0,0,0,0,0,0,0,0,0
funny_about_love,3.3,7,0,7,0,0,1,0,1,0,2.8,446,30
greatest_game_ever_played,6.2,109,68,41,62,5.7,27,15,12,55,3.6,15763,76
hometown_legend,0,2,0,2,0,0,0,0,0,0,0,0,0
how_i_got_into_college,4.6,8,3,5,37,0,0,0,0,0,0,0,0
map_of_the_human_heart,6.8,20,16,4,80,0,4,3,1,75,3.7,666,74
mr-blandings-builds-his-dream-house,7.1,14,11,3,78,0,0,0,0,0,0,0,0
my_favorite_wife,6.7,12,10,2,83,0,3,2,1,66,3.9,1364,85
new_adventures_of_pippi_longstocking,4.4,5,1,4,20,0,0,0,0,0,0,0,0
1015000-night_and_day,0,4,2,2,50,0,0,0,0,0,0,0,0
no_name_on_the_bullet,0,1,1,0,100,0,0,0,0,0,0,0,0
plainsman,0,0,0,0,0,0,0,0,0,0,0,0,0
snake_pit,0,3,3,0,100,0,0,0,0,0,0,0,0
1019653-spoilers,0,3,3,0,100,0,0,0,0,0,0,0,0
food-and-culture,0,0,0,0,0,0,0,0,0,0,0,0,0
taipan,3.7,5,1,4,20,0,1,0,1,0,2.9,427,37
1022225-two_of_a_kind,4,10,2,8,20,0,1,0,1,0,2.9,2389,40
13th_warrior,4.6,86,28,58,32,4.9,18,7,11,38,3.2,24204,66
posto,7.4,6,6,0,100,0,1,1,0,100,4.2,484,92
goodbye_columbus,7.1,9,9,0,100,0,0,0,0,0,0,0,0
presidents_analyst,7.1,20,16,4,80,8,5,5,0,100,3.6,371,73
day_of_the_locust,6.8,8,5,3,62,0,1,1,0,100,3.6,582,75
creeping_flesh,5.8,5,4,1,80,0,0,0,0,0,0,0,0
swann_in_love,0,4,3,1,75,0,1,1,0,100,3.2,261,48
to_end_all_wars,6.1,11,7,4,63,0,2,1,1,50,3.9,1957,85
1107863-moulin_rouge,7,168,130,38,77,6.1,35,23,12,65,3.7,110817,88
belly_of_an_architect,6.3,12,10,2,83,0,0,0,0,0,0,0,0
1132155-nest,0,0,0,0,0,0,0,0,0,0,0,0,0
love_happy,0,2,2,0,100,0,0,0,0,0,0,0,0
high_school_confidential,6.3,9,6,3,66,0,1,1,0,100,3.3,853,54
out-of-the-blue-no-looking-back,6.2,5,4,1,80,0,1,1,0,100,3.9,294,80
crimetime,0,1,0,1,0,0,0,0,0,0,0,0,0
a-woman-is-a-woman,7.4,28,24,4,85,7.6,10,9,1,90,4,2893,86
mamma_roma,7.8,9,9,0,100,0,0,0,0,0,0,0,0
lower_depths,8.2,5,4,1,80,0,1,1,0,100,3.9,685,82
ruby-cairo,0,0,0,0,0,0,0,0,0,0,0,0,0
1015060-night_patrol,0,0,0,0,0,0,0,0,0,0,0,0,0
biggles-adventures-in-time,0,0,0,0,0,0,0,0,0,0,0,0,0
fancy_pants,0,4,3,1,75,0,0,0,0,0,0,0,0
world_of_suzie_wong,0,2,2,0,100,0,0,0,0,0,0,0,0
1132084-king_of_the_ants,7.2,8,8,0,100,0,0,0,0,0,0,0,0
uncle_sam,5.1,9,5,4,55,0,0,0,0,0,0,0,0
yesterday_today_and_tomorrow,7.3,5,4,1,80,0,0,0,0,0,0,0,0
la_belle_noiseuse,8,22,22,0,100,8.2,6,6,0,100,3.9,797,83
1031278-gun_crazy,8.2,27,26,1,96,0,2,1,1,50,3.8,881,83
setup,5.9,6,5,1,83,0,0,0,0,0,0,0,0
recount-democracy,0,0,0,0,0,0,0,0,0,0,0,0,0
prime_of_miss_jean_brodie,6.9,14,13,1,92,0,2,2,0,100,3.8,987,81
my_voyage_to_italy,8.3,20,20,0,100,0,4,4,0,100,3.9,769,82
north_avenue_irregulars,5.1,7,5,2,71,0,0,0,0,0,0,0,0
lovers_and_other_strangers,0,4,3,1,75,0,1,1,0,100,3.4,328,50
kotch,0,4,2,2,50,0,1,0,1,0,3.4,272,59
greyfriars_bobby,0,0,0,0,0,0,0,0,0,0,0,0,0
side_out,0,4,0,4,0,0,0,0,0,0,0,0,0
three_lives_of_thomasina,0,4,2,2,50,0,0,0,0,0,0,0,0
no_deposit_no_return,0,0,0,0,0,0,0,0,0,0,0,0,0
one_and_only_genuine_original_family_band,0,0,0,0,0,0,0,0,0,0,0,0,0
1021269-this_gun_for_hire,7.3,13,12,1,92,0,1,1,0,100,3.7,648,80
1080192-black_angel,0,4,3,1,75,0,0,0,0,0,0,0,0
big_clock,7.6,6,6,0,100,0,0,0,0,0,0,0,0
crisscross,0,0,0,0,0,0,0,0,0,0,0,0,0
fifth_musketeer,0,1,1,0,100,0,0,0,0,0,0,0,0
evilspeak,4.1,5,2,3,40,0,0,0,0,0,0,0,0
sherlock_holmes_in_terror_by_night,6.5,7,5,2,71,0,0,0,0,0,0,0,0
spy_who_came_in_from_the_cold,7.6,12,10,2,83,0,3,2,1,66,0,0,0
sherlock_holmes_and_the_secret_weapon,0,2,1,1,50,0,0,0,0,0,0,0,0
sherlock_holmes_and_the_woman_in_green,7.2,8,8,0,100,0,0,0,0,0,0,0,0
counterfeit_traitor,0,3,2,1,66,0,0,0,0,0,0,0,0
sherlock_holmes_in_dressed_to_kill,6.2,5,4,1,80,0,0,0,0,0,0,0,0
1130780-bon_voyage,6.7,95,72,23,75,7.2,29,23,6,79,3.5,1025,69
assassination_bureau,5.9,5,4,1,80,0,2,2,0,100,3.5,334,69
1013227-manchurian_candidate,8.6,48,47,1,97,7.5,6,5,1,83,3.9,6006,89
thunderbirds,4.1,99,19,80,19,3.9,29,5,24,17,2.7,4133,45
village,5.4,199,84,115,42,5.7,39,19,20,48,3,47806,59
garden_state,7.4,184,158,26,85,7.1,36,30,6,83,3.8,90523,87
early_summer,8.8,9,9,0,100,0,1,1,0,100,4.1,762,91
thunderbirds_are_go,4.2,5,2,3,40,0,0,0,0,0,0,0,0
thunderbirds_6,0,3,1,2,33,0,0,0,0,0,0,0,0
castle_keep,5.4,7,3,4,42,0,3,1,2,33,3,755,46
1134283-revengers_tragedy,6.4,5,3,2,60,0,1,1,0,100,3.9,317,78
beyond_hypothermia,0,0,0,0,0,0,0,0,0,0,0,0,0
pulse2004,3.9,6,1,5,16,0,0,0,0,0,0,0,0
ptu,5.8,14,8,6,57,0,1,1,0,100,3.7,1107,79
unfinished_piece_for_player_piano,0,1,1,0,100,0,0,0,0,0,0,0,0
musa-the-warrior,0,1,1,0,100,0,0,0,0,0,0,0,0
funny_thing_happened_on_the_way_to_the_forum,7,17,14,3,82,0,0,0,0,0,0,0,0
1005521-death_of_a_salesman,8.2,7,7,0,100,0,0,0,0,0,0,0,0
collateral,7.4,223,192,31,86,7.2,44,36,8,81,3.5,43901,79
code_46,6.1,96,50,46,52,5.5,32,10,22,31,3.3,2456,59
1042122-in_the_soup,6.7,6,5,1,83,0,2,1,1,50,3.5,578,70
blue_spring,0,0,0,0,0,0,0,0,0,0,0,0,0
story_of_women,7.4,10,8,2,80,0,1,0,1,0,3.7,435,73
attack-the-gas-station,0,1,1,0,100,0,0,0,0,0,0,0,0
1053779-mask,6.4,44,33,11,75,6.1,9,5,4,55,3.2,68419,66
harold_and_kumar_go_to_white_castle,6.5,144,106,38,73,6.7,30,22,8,73,3.5,61100,79
princess_diaries_2_royal_engagement,4.6,113,29,84,25,4.8,28,10,18,35,3.2,63165,68
danny_deckchair,5.7,75,40,35,53,5.9,24,14,10,58,3.6,1705,74
alien_vs_predator,4.1,139,30,109,21,3.4,25,1,24,4,3,48807,51
yugioh,3,62,3,59,4,2.8,19,0,19,0,3,2474,53
novo,4.7,10,5,5,50,0,4,1,3,25,3.3,452,55
we_dont_live_here_anymore,6.4,122,79,43,64,6.8,34,24,10,70,3.2,2382,55
without_a_paddle,3.9,124,18,106,14,4.2,31,6,25,19,3.3,33540,73
exorcist_the_beginning,3.6,123,14,109,11,3.3,23,1,22,4,2.8,14563,42
it_happened_at_the_worlds_fair,3.9,6,1,5,16,0,0,0,0,0,0,0,0
harum_scarum,0,0,0,0,0,0,0,0,0,0,0,0,0
unidentified_flying_oddball,0,3,1,2,33,0,0,0,0,0,0,0,0
sting_2,0,0,0,0,0,0,0,0,0,0,0,0,0
human_resources,7.8,31,30,1,96,7.8,7,7,0,100,3.7,375,77
bill_cosby_himself,7,5,4,1,80,0,0,0,0,0,0,0,0
dead_ringers,7.7,35,29,6,82,5.7,6,3,3,50,3.6,4690,80
1134850-benji_off_the_leash,4.7,43,14,29,32,5,16,5,11,31,3.3,551,60
anacondas_the_hunt_for_the_blood_orchid,4.3,116,31,85,26,4.5,28,8,20,28,2.5,14394,43
suspect_zero,4.4,129,23,106,17,4.6,32,7,25,21,3,2578,43
warriors_of_heaven_and_earth,6.1,31,21,10,67,5.6,10,5,5,50,3.3,1053,57
vanity_fair,5.8,162,81,81,50,5.8,41,23,18,56,3,9329,52
cookout,2.8,42,2,40,4,2.6,14,1,13,7,2.9,1132,50
paparazzi,3.4,77,14,63,18,2.8,14,0,14,0,2.8,2849,43
wicker_park,4.3,120,28,92,23,4.3,30,7,23,23,3.5,12752,79
trigger_man,6.9,9,8,1,88,0,3,3,0,100,2.8,140,45
alice_doesnt_live_here_anymore,7.8,19,18,1,94,0,4,3,1,75,0,0,0
mangler,2.5,9,2,7,22,0,1,0,1,0,2.4,1314,25
whos_that_knocking_at_my_door,6.1,13,9,4,69,0,4,1,3,25,3.4,1323,61
seeing_other_people,5.5,33,13,20,39,5.3,13,6,7,46,2.9,579,35
past_midnight,0,0,0,0,0,0,0,0,0,0,0,0,0
million_to_juan,0,2,0,2,0,0,0,0,0,0,0,0,0
camera_buff,7.3,9,8,1,88,0,3,2,1,66,4,656,88
no_end,7.3,10,9,1,90,0,3,2,1,66,3.9,354,79
1127803-highwaymen,3.2,15,2,13,13,0,1,0,1,0,3,1050,42
graffiti_bridge,4.9,8,3,5,37,0,1,0,1,0,3,996,47
i_vitelloni,8.8,22,22,0,100,8.9,11,11,0,100,4.1,1679,90
under_the_cherry_moon,3.8,22,6,16,27,5.3,5,2,3,40,3.3,1076,65
1070621-flipper,4.8,17,5,12,29,5.4,5,1,4,20,2.6,6086,44
10005057-smile,4,13,2,11,15,3.9,5,1,4,20,3.5,585,69
lord-jim,5.7,13,7,6,53,0,3,0,3,0,3.3,613,54
small_circle_of_friends,0,1,1,0,100,0,0,0,0,0,0,0,0
night_of_the_demons_3,0,2,0,2,0,0,0,0,0,0,0,0,0
witchboard,4.8,8,3,5,37,0,0,0,0,0,0,0,0
roller_boogie,3,6,0,6,0,0,1,0,1,0,3,585,49
1001131-apple,4.6,6,1,5,16,0,0,0,0,0,0,0,0
super_babies_baby_geniuses_2,2.2,40,0,40,0,2.5,17,0,17,0,2.1,1335,28
cellular,5.8,146,80,66,54,5.8,32,17,15,53,3.2,13185,63
resident_evil_apocalypse,3.9,121,25,96,20,3.3,26,2,24,7,3.3,56756,70
10003276-criminal,6.4,118,82,36,69,6.7,34,25,9,73,3.3,1400,58
mr_3000,5.9,104,58,46,55,6.1,34,20,14,58,2.6,2928,35
sky_captain,6.8,204,147,57,72,6.6,38,26,12,68,2.8,17325,43
wimbledon,5.9,142,86,56,60,5.6,33,18,15,54,3.1,14484,57
anatomy_of_hell,3.6,34,9,25,26,3.7,15,4,11,26,2.9,861,42
head_in_the_clouds,4.3,87,13,74,14,4.2,31,4,27,12,3.4,2782,62
first_daughter,3.7,83,7,76,8,3.5,24,0,24,0,2.8,13699,50
forgotten,5,168,51,117,30,4.7,34,10,24,29,2.9,13766,47
last_shot,5.9,66,40,26,60,5.7,21,13,8,61,2.8,795,30
adictos_2005,0,0,0,0,0,0,0,0,0,0,0,0,0
motorcycle_diaries,7.5,153,128,25,83,7.6,37,31,6,83,4.1,22395,91
shaun_of_the_dead,7.7,175,159,16,90,7.6,33,31,2,93,3.9,110759,91
come_back_little_sheba,6.4,6,4,2,66,0,0,0,0,0,0,0,0
black_orchid,4.6,5,1,4,20,0,1,0,1,0,3.6,104,66
class_of_nuke_em_high_2_subhumanoid_meltdown,0,1,0,1,0,0,0,0,0,0,0,0,0
murder_on_the_orient_express,7.4,19,19,0,100,0,1,1,0,100,3.5,3826,74
1053779-mask,6.4,44,33,11,75,6.1,9,5,4,55,3.2,68419,66
alexanders_ragtime_band,0,2,1,1,50,0,0,0,0,0,0,0,0
1002939-boston_strangler,6.5,12,11,1,91,0,1,1,0,100,3.5,672,73
last_flight_of_noahs_ark,4.4,5,2,3,40,0,1,0,1,0,2.9,399,42
man_with_one_red_shoe,4.6,13,6,7,46,0,1,0,1,0,2.8,2768,38
sentinel,5,134,44,90,32,5.1,32,11,21,34,3.1,26716,47
sssssss,3.4,7,1,6,14,0,0,0,0,0,0,0,0
whispers_in_the_dark,4.6,7,2,5,28,0,1,0,1,0,2.9,293,31
1012162-legacy,0,1,1,0,100,0,0,0,0,0,0,0,0
alligator_people,0,3,1,2,33,0,0,0,0,0,0,0,0
see_no_evil_hear_no_evil,3.4,11,2,9,18,0,1,0,1,0,3.3,6015,72
basket_case_2,0,4,4,0,100,0,0,0,0,0,0,0,0
orca_the_killer_whale,3.8,12,2,10,16,0,0,0,0,0,0,0,0
1134304-aka,6.2,31,18,13,58,6.6,12,8,4,66,3.1,250,50
i-married-a-monster-from-outer-space,6.2,12,10,2,83,0,0,0,0,0,0,0,0
trojan_women,0,2,2,0,100,0,1,1,0,100,3.1,225,50
1110937-robinson_crusoe,0,3,1,2,33,0,0,0,0,0,0,0,0
1009219-hardcore,6.7,19,16,3,84,0,1,1,0,100,3.4,560,64
watermelon_man,0,3,3,0,100,0,0,0,0,0,0,0,0
bug,6.2,128,76,52,59,6.6,36,24,12,66,2.5,168834,31
planet_terror,6.1,23,17,6,73,0,0,0,0,0,0,0,0
1492_conquest_of_paradise,4.1,16,7,9,43,0,2,1,1,50,3,3372,47
cannibal_holocaust,5.2,11,7,4,63,0,0,0,0,0,0,0,0
shark_tale,5.2,173,61,112,35,5.5,34,13,21,38,3.2,78877,59
the-art-of-russell-oberlin2004,0,0,0,0,0,0,0,0,0,0,0,0,0
i_heart_huckabees,6.3,184,113,71,61,5.7,41,21,20,51,3.3,38441,75
raise_your_voice,3.7,83,13,70,15,3.9,27,6,21,22,3.3,56922,74
taxi,3.4,104,11,93,10,3.8,27,5,22,18,2.8,15669,60
around_the_bend,4.9,94,27,67,28,4.7,30,7,23,23,3.4,1012,65
primer,6.5,115,83,32,72,6.4,28,20,8,71,3.8,10817,82
coming-to-the-stage,0,0,0,0,0,0,0,0,0,0,0,0,0
shall_we_dance,5.4,152,69,83,45,5.2,37,16,21,43,3,26935,63
team_america_world_police,6.9,191,145,46,75,6.4,38,26,12,68,3.4,43078,78
eulogy,4.6,34,11,23,32,3.9,9,1,8,11,3.6,2744,71
ps,5.8,78,43,35,55,5.6,27,14,13,51,3,1406,41
1004798-country_girl,7.2,6,5,1,83,0,0,0,0,0,0,0,0
rose_tattoo,7.8,5,4,1,80,0,0,0,0,0,0,0,0
epidemic,5.4,6,2,4,33,0,2,2,0,100,3.3,1016,60
tess,7,16,13,3,81,0,4,4,0,100,3.6,1705,73
i_wanna_hold_your_hand,6.4,17,14,3,82,0,1,0,1,0,3.5,625,72
spinning-boris,0,0,0,0,0,0,0,0,0,0,0,0,0
circle_of_iron,4.6,7,3,4,42,0,0,0,0,0,0,0,0
cannonball_run,4.2,29,9,20,31,0,3,0,3,0,3.1,6545,59
fearless_vampire_killers_or_pardon_me_but_your_teeth_are_in_my_neck,6.1,29,19,10,65,0,4,2,2,50,3.8,3901,77
1126533-black_friday,0,0,0,0,0,0,0,0,0,0,0,0,0
five_obstructions,7.6,57,50,7,87,8,15,14,1,93,4,1809,84
born-rich2003,0,0,0,0,0,0,0,0,0,0,0,0,0
its_alive_unrated,0,1,0,1,0,0,0,0,0,0,0,0,0
le-declin-de-lempire-americain,7.3,12,11,1,91,0,1,1,0,100,3.7,1522,79
bebes_kids,4.1,7,1,6,14,0,0,0,0,0,0,0,0
1039460-all_i_want_for_christmas,2.3,6,0,6,0,0,1,0,1,0,3.1,1740,55
life_and_nothing_but,0,4,4,0,100,0,0,0,0,0,0,0,0
friday_night_lights,7.1,166,134,32,80,7.5,39,34,5,87,3.6,36154,84
tarnation,7.6,100,92,8,92,8.2,34,33,1,97,3.9,2007,82
final_cut,5.4,75,29,46,38,4.9,26,8,18,30,3,4745,48
riding-the-bullet,4.2,21,6,15,28,3.1,6,0,6,0,2.9,1830,40
1137336-1137336-spin,5.1,7,3,4,42,0,1,0,1,0,3.7,271,71
being_julia,6.7,123,94,29,76,6.5,35,24,11,68,3.5,1947,71
dust_factory,2.9,11,1,10,9,0,3,0,3,0,3.6,977,65
therese,7.8,6,5,1,83,0,2,1,1,50,3.8,225,78
surviving_christmas,3,109,8,101,7,2.9,29,2,27,6,2.6,4192,37
grudge,5.1,153,61,92,39,4.8,33,8,25,24,2.9,54794,57
alfie,5.5,149,73,76,48,5.2,38,16,22,42,2.9,15367,49
sideways,8.6,212,205,7,96,8.7,42,41,1,97,3.4,35809,77
machinist,6.6,132,99,33,75,6.7,33,25,8,75,3.7,41645,82
vera_drake,7.9,155,142,13,91,8,40,36,4,90,3.8,3338,82
fallen_angels_hong_kong,7.9,19,18,1,94,0,4,4,0,100,4,4014,86
1136293-lightning_in_a_bottle,7.4,61,53,8,86,7.4,22,20,2,90,3.6,343,78
undertow,5.9,116,64,52,55,6.1,34,19,15,55,3.4,1926,65
enduring_love,6.2,96,57,39,59,6.2,34,20,14,58,3.3,2543,60
saw,5.4,161,77,84,47,4.9,32,10,22,31,3.7,144186,86
ray,7.3,194,157,37,80,7.7,41,35,6,85,3.8,32696,87
birth,5.2,138,54,84,39,5.3,39,14,25,35,2.8,5483,41
1164418-voices_of_iraq,6.1,15,9,6,60,5.9,12,6,6,50,4,111,86
down-syndrome-the-first-18-months2004,0,0,0,0,0,0,0,0,0,0,0,0,0
1006975-fade_to_black,4.9,11,5,6,45,0,1,1,0,100,3.3,379,54
polar_express,6.4,186,104,82,55,6.2,39,21,18,53,3.2,22358,65
kinsey,7.6,187,168,19,89,7.9,39,36,3,92,3.4,6162,72
seed_of_chucky,4.4,71,23,48,32,3.9,18,2,16,11,2.6,15727,52
after_the_sunset,4.4,138,25,113,18,4.2,33,4,29,12,3.1,6886,56
bridget_jones_the_edge_of_reason,4.7,149,40,109,26,4.7,35,10,25,28,3.1,41759,64
finding_neverland,7.4,200,165,35,82,7.3,39,31,8,79,3.7,77596,84
1195356-veer_zaara,0,3,3,0,100,0,2,2,0,100,4.2,4026,87
national-treasure-2-book-of-secrets,4.7,118,39,79,33,4.6,25,8,17,32,3.6,1237906,72
bad_education,7.5,134,118,16,88,7.8,35,30,5,85,3.9,13423,85
spongebob_squarepants_movie,6.2,123,84,39,68,6.2,33,23,10,69,3.2,19811,74
770872734,0,0,0,0,0,0,0,0,0,0,0,0,0
alexander,3.9,193,31,162,16,4,41,5,36,12,2.7,29540,43
christmas_with_the_kranks,2.8,131,6,125,4,3.4,33,1,32,3,2.9,11697,46
guerrilla-the-taking-of-patty-hearst,0,0,0,0,0,0,0,0,0,0,0,0,0
notre_musique,6.6,54,36,18,66,6.9,17,12,5,70,3.7,949,69
closer,6.6,201,137,64,68,6.6,42,31,11,73,3.5,50768,80
i_am_david,5.2,34,13,21,38,5.3,10,3,7,30,4,1967,86
house_of_flying_daggers,7.8,163,143,20,87,8.1,39,37,2,94,3.6,35657,81
oceans_twelve,5.9,174,96,78,55,6.1,38,23,15,60,3.4,108512,67
blade_trinity,4.5,162,43,119,26,4.4,33,7,26,21,3.4,62827,70
bellboy,6.9,9,6,3,66,0,0,0,0,0,0,0,0
monde-selon-bush-le,0,0,0,0,0,0,0,0,0,0,0,0,0
cinderfella,0,4,3,1,75,0,0,0,0,0,0,0,0
1005152-damn_yankees,5.9,7,5,2,71,0,0,0,0,0,0,0,0
delicate_delinquent,0,3,1,2,33,0,0,0,0,0,0,0,0
errand_boy,5.7,8,4,4,50,0,0,0,0,0,0,0,0
family_jewels,0,4,3,1,75,0,0,0,0,0,0,0,0
1101029-ladies_man,3.2,71,8,63,11,3.3,18,3,15,16,2.6,2790,43
1157715-doing_time_for_patsy_cline,6.1,9,7,2,77,0,4,2,2,50,2.7,50,33
stateside,4.3,46,11,35,23,4.1,20,4,16,20,3.4,526,62
stooge,0,1,0,1,0,0,0,0,0,0,0,0,0
thats_entertainment,8,13,13,0,100,0,1,1,0,100,3.7,1093,79
thats-entertainment-2,0,3,2,1,66,0,0,0,0,0,0,0,0
thats-entertainment-iii,0,0,0,0,0,0,0,0,0,0,0,0,0
wackiest_ship_in_the_army,0,2,1,1,50,0,0,0,0,0,0,0,0
alexander,3.9,193,31,162,16,4,41,5,36,12,2.7,29540,43
1040442-conquest_of_space,0,3,2,1,66,0,0,0,0,0,0,0,0
daryl,3.7,6,2,4,33,0,0,0,0,0,0,0,0
fire_in_the_sky,5.1,14,5,9,35,0,3,0,3,0,3.1,2891,56
1135169-ill_be_seeing_you,0,1,1,0,100,0,0,0,0,0,0,0,0
invisible_man_returns,5.9,9,8,1,88,0,0,0,0,0,0,0,0
love_me_if_you_dare,5.2,78,34,44,43,5.1,26,10,16,38,4.2,14602,90
portrait-of-jennie,7.9,11,10,1,90,0,0,0,0,0,0,0,0
ruby_gentry,6.9,6,4,2,66,0,1,1,0,100,3.1,162,43
secret_honor,7.4,11,8,3,72,0,3,2,1,66,3.6,540,72
since_you_went_away,6.5,6,4,2,66,0,0,0,0,0,0,0,0
slipping-down-life,4.7,65,17,48,26,4.5,24,7,17,29,3.2,316,49
charles-dickens-the-man-who-asked-for-more,0,0,0,0,0,0,0,0,0,0,0,0,0
control_room,7.8,108,104,4,96,7.8,29,28,1,96,3.9,1430,86
1140725-celsius_4111,3.9,18,2,16,11,4,10,1,9,10,2.6,208,26
dr_jekyll_and_mr_hyde,0,1,0,1,0,0,0,0,0,0,0,0,0
golem,7.9,8,8,0,100,0,1,1,0,100,0,0,0
haxan,7.4,15,13,2,86,0,1,1,0,100,3.8,1213,80
1010215-hunchback_of_notre_dame,8.3,9,9,0,100,0,0,0,0,0,0,0,0
sherlock-jr,0,0,0,0,0,0,0,0,0,0,0,0,0
10009001-the_freshman,7.3,32,30,2,93,7.2,8,7,1,87,3.1,2525,52
1008924-greed,9.3,16,16,0,100,0,4,4,0,100,0,0,0
phantom_of_the_opera,5,165,54,111,32,4.6,37,10,27,27,3.7,70849,86
1010979-jazz_singer,3.7,20,3,17,15,0,3,1,2,33,3.4,857,71
oktyabr-october-ten-days-that-shook-the-world,7.1,7,6,1,85,0,1,1,0,100,4,780,83
unknown,5.1,44,17,27,38,4.6,17,4,13,23,3.3,6616,57
pandoras_box,8.5,23,21,2,91,8.1,8,6,2,75,4.1,1316,88
the-cameraman-1928,8.8,13,13,0,100,0,0,0,0,0,0,0,0
1098652-in_crowd,2.7,52,1,51,1,2.4,14,0,14,0,2.6,925,41
steamboat_bill_jr,9.1,15,15,0,100,0,0,0,0,0,0,0,0
un-chien-andalou-an-andalusian-dog,9.2,18,18,0,100,0,3,3,0,100,4.1,5685,86
little_caesar,7.6,17,15,2,88,0,2,2,0,100,3.6,1977,72
lage_dor,8.7,23,21,2,91,0,2,2,0,100,4,1547,82
1014137-monkey_business,7.8,12,11,1,91,0,0,0,0,0,0,0,0
return_of_doctor_x,0,3,0,3,0,0,0,0,0,0,0,0,0
1018324-scarface,7.5,50,44,6,88,8,5,4,1,80,4.1,121090,93
interview_with_the_vampire,5.8,45,26,19,57,4.6,10,4,6,40,3.7,77706,85
1005875-dinner_at_eight,8.6,16,16,0,100,0,0,0,0,0,0,0,0
gold_diggers_of_1933,9,8,8,0,100,0,0,0,0,0,0,0,0
island-of-lost-souls,0,0,0,0,0,0,0,0,0,0,0,0,0
son_of_kong,4.6,9,3,6,33,0,0,0,0,0,0,0,0
latalante,8.7,23,23,0,100,8,7,7,0,100,4.3,1388,91
balls_of_fury,4.2,127,29,98,22,4.5,24,8,16,33,2.8,85682,36
mr_deeds_goes_to_town,8.4,13,12,1,92,0,0,0,0,0,0,0,0
petrified_forest,7.6,8,8,0,100,0,0,0,0,0,0,0,0
wife_vs_secretary,0,0,0,0,0,0,0,0,0,0,0,0,0
1003441-camille,7.3,10,9,1,90,0,1,1,0,100,3.9,1060,82
10003925-dead_end,6.1,7,6,1,85,0,0,0,0,0,0,0,0
nothing_sacred,9,9,9,0,100,0,0,0,0,0,0,0,0
1016757-prisoner_of_zenda,0,1,0,1,0,0,0,0,0,0,0,0,0
stage_door_canteen,0,2,1,1,50,0,0,0,0,0,0,0,0
holiday_2006,0,0,0,0,0,0,0,0,0,0,0,0,0
roaring_twenties,7.3,10,10,0,100,0,0,0,0,0,0,0,0
1024192-wuthering_heights,7.9,16,16,0,100,0,1,1,0,100,3.9,2525,84
letters_from_iwo_jima,8.2,196,178,18,90,8.3,40,37,3,92,3.8,73433,85
1018433-sea_hawk,8.7,12,12,0,100,0,0,0,0,0,0,0,0
ball_of_fire,8.3,23,23,0,100,0,4,4,0,100,4.1,864,89
here_comes_mr_jordan,7.4,15,15,0,100,0,0,0,0,0,0,0,0
across_the_pacific,0,2,2,0,100,0,0,0,0,0,0,0,0
prelude-to-war,0,0,0,0,0,0,0,0,0,0,0,0,0
random_harvest,7.6,9,8,1,88,0,0,0,0,0,0,0,0
action_in_the_north_atlantic,0,1,1,0,100,0,0,0,0,0,0,0,0
1009426-heaven_can_wait,7.8,9,8,1,88,0,0,0,0,0,0,0,0
the-memphis-belle,0,0,0,0,0,0,0,0,0,0,0,0,0
vredens-dag-day-of-wrath-day-of-anger,8.5,20,20,0,100,7.5,5,5,0,100,4.2,732,92
1004832-cover_girl,6.9,9,8,1,88,0,0,0,0,0,0,0,0
curse_of_the_cat_people,7.3,23,20,3,86,0,3,2,1,66,0,0,0
1029042-henry_v,8.2,32,32,0,100,7.8,7,7,0,100,4,3619,87
mask_of_dimitrios,0,2,2,0,100,0,0,0,0,0,0,0,0
ministry_of_fear,7.2,10,10,0,100,0,0,0,0,0,0,0,0
miracle_of_morgans_creek,8.1,20,18,2,90,0,3,3,0,100,3.9,836,83
mr_skeffington,6.4,6,4,2,66,0,0,0,0,0,0,0,0
passage-to-marseille,0,0,0,0,0,0,0,0,0,0,0,0,0
ivan-the-terrible-pt-1,8.7,9,9,0,100,0,1,1,0,100,4.1,999,90
they_were_expendable,7.9,8,7,1,87,0,0,0,0,0,0,0,0
1081200-great_expectations,5.4,32,12,20,37,5.4,7,3,4,42,3.4,10607,76
humoresque,5.9,5,3,2,60,0,0,0,0,0,0,0,0
the_strangers,5,146,65,81,44,4.8,26,13,13,50,3.1,55773,48
1144535-nightmare_alley,7.8,10,10,0,100,0,2,2,0,100,3.9,576,83
1015383-odd_man_out,8,22,22,0,100,0,3,3,0,100,4,556,84
road_to_rio,6.8,6,6,0,100,0,0,0,0,0,0,0,0
godfather,9,66,66,0,100,8.4,11,11,0,100,4.4,172072,97
easter_parade,7.3,17,15,2,88,0,4,4,0,100,3.8,2172,83
fort_apache,8.3,13,13,0,100,0,0,0,0,0,0,0,0
the-lady-from-shanghai-2010,0,0,0,0,0,0,0,0,0,0,0,0,0
yi-ge-mo-sheng-nu-ren-de-lai-xin-a-letter-from-an-unknown-woman,0,0,0,0,0,0,0,0,0,0,0,0,0
louisiana_story,7.3,14,11,3,78,0,2,2,0,100,3.4,214,59
1040398-naked_city,7.2,12,11,1,91,0,2,2,0,100,3.8,960,78
1046772-three_musketeers,4.8,24,7,17,29,0,3,0,3,0,3.2,13783,67
1022369-unfaithfully_yours,7.8,14,13,1,92,0,2,2,0,100,3.9,650,86
in_the_good_old_summertime,6.5,7,5,2,71,0,2,1,1,50,3.8,870,79
letter_to_three_wives,8.5,10,10,0,100,0,1,1,0,100,3.8,921,82
orpheus,9.5,15,15,0,100,0,1,1,0,100,4.2,1007,91
les_enfants_terribles,6.6,8,6,2,75,0,1,1,0,100,3.8,405,74
1009055-gunfighter,7.6,7,7,0,100,0,0,0,0,0,0,0,0
1011638-king_solomons_mines,7.4,11,10,1,90,0,0,0,0,0,0,0,0
los-olvidados-1950,8.8,31,29,2,93,0,4,3,1,75,4.4,1531,95
1072404-scandal,0,4,3,1,75,0,1,1,0,100,3.6,527,69
1003625-carrie,8,42,38,4,90,6.4,7,4,3,57,3.3,23161,70
life_of_oharu,8.8,8,8,0,100,0,0,0,0,0,0,0,0
abbott_and_costello_meet_dr_jekyll_and_mr_hyde,6,6,5,1,83,0,0,0,0,0,0,0,0
z_channel,8,13,13,0,100,0,0,0,0,0,0,0,0
samurai_1_musashi_miyamoto,0,2,2,0,100,0,0,0,0,0,0,0,0
1019828-star_is_born,7.3,11,11,0,100,0,0,0,0,0,0,0,0
into_the_wild,7.5,181,149,32,82,7.2,37,27,10,72,4.2,82515,90
mr-arkadin-confidential-report,7.1,18,15,3,83,0,2,2,0,100,3.9,707,80
samurai_2_duel_at_ichijoji_temple,0,0,0,0,0,0,0,0,0,0,0,0,0
tuntematon-sotilas-the-unknown-soldier,0,0,0,0,0,0,0,0,0,0,0,0,0
samurai_3_duel_at_ganryu_island,0,0,0,0,0,0,0,0,0,0,0,0,0
1129129-teachers_pet,6.5,72,54,18,75,6.7,25,19,6,76,2.8,370,38
human-condition-ii-the-road-to-eternity,0,0,0,0,0,0,0,0,0,0,0,0,0
fires_on_the_plain,7.8,13,13,0,100,0,4,4,0,100,4.2,428,91
1053613-pickpocket,9.3,19,19,0,100,0,2,2,0,100,4.1,1733,88
floating_weeds,8.4,20,19,1,95,0,3,3,0,100,4.2,745,91
onna-ga-kaidan-wo-agaru-toki-when-a-woman-ascends-the-stairs,8.2,13,13,0,100,0,0,0,0,0,0,0,0
the-warui-yatsu-hodo-yoku-nemuru-the-bad-sleep-well,7.7,16,16,0,100,0,3,3,0,100,4.1,1723,91
deadly_companions,6.4,5,4,1,80,0,1,0,1,0,3.2,166,38
human-condition-iii-a-soldiers-prayer,0,0,0,0,0,0,0,0,0,0,0,0,0
advise_and_consent,7.7,10,8,2,80,0,2,1,1,50,3.9,594,88
david_and_lisa,7.1,10,8,2,80,0,3,2,1,66,0,0,0
harakiri_1963,0,3,3,0,100,0,1,1,0,100,4.5,1585,96
1014453-music_man,7.9,15,14,1,93,0,0,0,0,0,0,0,0
1014481-mutiny_on_the_bounty,8.2,28,26,2,92,7.5,6,5,1,83,3.7,1846,79
leclisse,7.4,15,13,2,86,0,4,3,1,75,4.2,1924,90
cardinal,6,10,6,4,60,0,2,1,1,50,3.4,252,53
mclintock,0,3,2,1,66,0,0,0,0,0,0,0,0
prize_winner_of_defiance_ohio,6.1,79,46,33,58,6.1,28,14,14,50,3.2,7811,55
1068456-36_hours,0,1,1,0,100,0,0,0,0,0,0,0,0
becket,7.3,24,18,6,75,6.4,9,6,3,66,4.1,1602,88
behold_a_pale_horse,7,7,6,1,85,0,2,1,1,50,3.4,71,65
unhitched,0,1,1,0,100,0,0,0,0,0,0,0,0
hushhush_sweet_charlotte,7.3,19,16,3,84,0,0,0,0,0,0,0,0
natural_born_killers,6,29,15,14,51,5.9,7,3,4,42,3.5,39062,80
the-naked-kiss,7.4,9,8,1,88,0,0,0,0,0,0,0,0
onibaba,6.6,11,9,2,81,0,3,1,2,33,4.1,1496,91
robin_and_the_seven_hoods,5.9,9,4,5,44,0,0,0,0,0,0,0,0
robinson_crusoe_on_mars,6.4,12,11,1,91,0,0,0,0,0,0,0,0
what_a_way_to_go,4.1,5,0,5,0,0,2,0,2,0,3.7,212,67
battle_of_algiers,9,70,69,1,98,8.9,17,17,0,100,4.4,4133,95
charlie_brown_christmas,8.5,12,11,1,91,0,0,0,0,0,0,0,0
dracula_prince_of_darkness,6.3,12,10,2,83,0,1,0,1,0,3.3,1485,63
hallelujah_trail,0,3,2,1,66,0,0,0,0,0,0,0,0
1010034-house_on_haunted_hill,7,19,18,1,94,0,2,1,1,50,3.4,4234,70
in_harms_way,5.2,10,5,5,50,0,0,0,0,0,0,0,0
major_dundee,7.3,30,29,1,96,7.3,14,14,0,100,3.3,808,61
operation_crossbow,5.7,5,3,2,60,0,0,0,0,0,0,0,0
thousand_clowns,6.9,9,7,2,77,0,0,0,0,0,0,0,0
strangers_on_a_train,8.7,40,39,1,97,7.3,5,4,1,80,4,9106,91
andrei-rublev,8.7,14,13,1,92,0,2,1,1,50,4.5,3531,94
balthazar,9.2,29,29,0,100,9,7,7,0,100,4.2,1694,87
batman_the_movie,6.2,22,18,4,81,0,1,1,0,100,3,13951,51
khartoum,6.6,9,8,1,88,0,0,0,0,0,0,0,0
closely-watched-trains,7.7,14,14,0,100,0,1,1,0,100,4,1286,87
tokyo_drifter,7.5,7,7,0,100,0,1,1,0,100,0,0,0
dont-look-back,8.4,17,17,0,100,0,4,4,0,100,4.2,1544,91
bride_wore_black,7.6,9,9,0,100,0,3,3,0,100,3.7,1464,78
playtime,8.7,34,34,0,100,8.3,9,9,0,100,4.3,2267,91
grosse_pointe_blank,7.1,57,44,13,77,6.5,15,11,4,73,3.7,17815,85
beyond-the-gates,7.2,60,50,10,83,6.5,18,13,5,72,3.9,11089,81
titicut_follies,7.2,5,5,0,100,0,1,1,0,100,4.2,367,91
two_for_the_road,7.2,12,10,2,83,0,0,0,0,0,0,0,0
star_wagon,0,0,0,0,0,0,0,0,0,0,0,0,0
dracula_has_risen_from_the_grave,6.6,13,10,3,76,0,0,0,0,0,0,0,0
monkees-in-head,0,0,0,0,0,0,0,0,0,0,0,0,0
i-love-you-alice-b-toklas1968,0,0,0,0,0,0,0,0,0,0,0,0,0
yours_mine_and_ours,3.3,105,6,99,5,3.7,28,1,27,3,3.2,36270,64
alices_restaurant,6,14,9,5,64,0,4,3,1,75,3.4,935,61
colossus_the_forbin_project,0,4,4,0,100,0,0,0,0,0,0,0,0
my_night_at_mauds,8,15,14,1,93,0,2,2,0,100,4.1,2027,85
more,0,3,1,2,33,0,1,0,1,0,3.7,386,71
dodesukaden-clickety-clack,5.8,6,3,3,50,0,0,0,0,0,0,0,0
claires_knee,8.4,19,18,1,94,0,3,3,0,100,3.9,808,82
hi_mom,7.2,8,5,3,62,0,0,0,0,0,0,0,0
a-swedish-love-story,0,0,0,0,0,0,0,0,0,0,0,0,0
on_a_clear_day_you_can_see_forever,6.3,8,8,0,100,0,0,0,0,0,0,0,0
performance,7.4,19,17,2,89,0,1,0,1,0,3.9,1292,81
beguiled,6.9,10,9,1,90,0,0,0,0,0,0,0,0
devils_advocate,6.2,43,28,15,65,5.8,10,4,6,40,3.4,30966,78
1006345-duel,7.7,36,31,5,86,0,2,1,1,50,3.6,6809,80
johnny_got_his_gun,6.6,20,14,6,70,0,4,1,3,25,4.1,1730,88
they_call_me_trinity,0,2,0,2,0,0,1,0,1,0,3.7,1690,79
mon_oncle_antoine,0,4,4,0,100,0,0,0,0,0,0,0,0
el_topo,6.8,31,23,8,74,6.8,6,4,2,66,4.1,4272,86
dr_phibes_rises_again,5.5,9,4,5,44,0,0,0,0,0,0,0,0
lone_wolf_and_cub_baby_cart_at_the_river_styx,0,4,4,0,100,0,0,0,0,0,0,0,0
lady_sings_the_blues,6.7,12,9,3,75,0,4,3,1,75,3.9,1795,85
slither,6.9,129,110,19,85,6.4,29,22,7,75,3.2,31835,58
1103281-traffic,8,149,136,13,91,7.8,39,36,3,92,3.5,26217,81
charley_varrick,7.4,7,6,1,85,0,0,0,0,0,0,0,0
dark_star,6.5,21,17,4,80,0,4,2,2,50,3.4,3930,65
1162563-emperor_of_the_north,0,4,3,1,75,0,2,1,1,50,3.8,503,81
my_name_is_nobody,0,1,1,0,100,0,0,0,0,0,0,0,0
save_the_tiger,7,10,9,1,90,0,1,1,0,100,3.5,617,63
1018318-scarecrow,7.7,12,8,4,66,0,3,1,2,33,3.7,1738,79
banger_sisters,5.3,140,66,74,47,5.1,34,14,20,41,2.7,4139,45
theatre_of_blood,7.4,23,22,1,95,0,2,2,0,100,3.6,1253,75
california_split,7.3,11,10,1,90,7.1,5,4,1,80,3.8,753,81
phantom_of_liberty,8.3,16,14,2,87,0,4,4,0,100,4.1,1386,90
groove_tube,3.8,8,1,7,12,0,0,0,0,0,0,0,0
holy_mountain,6.9,18,15,3,83,7.5,6,6,0,100,4.3,3854,90
adventure_of_sherlock_holmes_smarter_brother,0,2,1,1,50,0,0,0,0,0,0,0,0
dolemite,4.6,5,2,3,40,0,0,0,0,0,0,0,0
great_waldo_pepper,5.9,7,5,2,71,0,1,1,0,100,3.2,560,50
night_moves,7.4,17,14,3,82,0,4,4,0,100,0,0,0
the-passenger-professione-reporter,8.1,64,58,6,90,9,15,15,0,100,4,2771,85
1000039-1900,5.9,14,6,8,42,0,3,0,3,0,4.1,2572,86
small_change,7.7,11,11,0,100,0,3,3,0,100,4,793,85
from_noon_till_three,0,1,0,1,0,0,0,0,0,0,0,0,0
harlan_county_usa,9.1,7,7,0,100,0,2,2,0,100,4.2,797,88
1019017-silver_streak,6.4,18,15,3,83,0,1,1,0,100,3.4,1982,68
jesus_of_nazareth-1977,0,3,3,0,100,0,0,0,0,0,0,0,0
high_anxiety,6.4,26,19,7,73,0,1,0,1,0,3.4,4006,67
1010004-hound_of_the_baskervilles,7.8,11,11,0,100,0,0,0,0,0,0,0,0
gangs_of_new_york,7.1,200,149,51,74,6.5,42,28,14,66,3.5,35768,76
1019441-sorcerer,7.1,15,12,3,80,0,1,1,0,100,3.8,787,79
1022131-turning_point,5.9,11,6,5,54,0,0,0,0,0,0,0,0
capricorn_one,6,17,10,7,58,0,1,0,1,0,0,0,0
snake_in_the_eagles_shadow,0,2,1,1,50,0,0,0,0,0,0,0,0
wedding_crashers,6.7,180,135,45,75,6.9,38,28,10,73,3.5,215271,70
hair,7.2,15,14,1,93,0,0,0,0,0,0,0,0
inlaws,4.9,126,44,82,34,4.9,35,12,23,34,2.9,2546,42
opening_night,7.8,21,20,1,95,0,3,3,0,100,4.1,1012,91
1062483-bad_boys,4.8,41,16,25,39,3.7,9,1,8,11,3.5,67658,79
dc_cab,0,2,0,2,0,0,0,0,0,0,0,0,0
el_norte,7.5,9,8,1,88,0,0,0,0,0,0,0,0
merry_christmas_mr_lawrence,6.2,19,15,4,78,5,5,2,3,40,3.9,1571,83
1016365-pirates_of_penzance,7.3,12,10,2,83,0,0,0,0,0,0,0,0
rock-rule,0,3,1,2,33,0,0,0,0,0,0,0,0
rumble_fish,6,23,16,7,69,5,5,2,3,40,3.6,6328,78
star_80,7.3,9,8,1,88,0,1,1,0,100,3.3,628,62
star_chamber,6,14,10,4,71,0,1,0,1,0,3,539,40
1021557-to_be_or_not_to_be,8.7,34,33,1,97,7,5,4,1,80,4.2,1733,92
twilight_zone_the_movie,5.8,30,20,10,66,0,4,2,2,50,3.2,7313,56
1075781-suburbia,6.3,21,13,8,61,6.4,6,3,3,50,3.3,1247,66
yellowbeard,5,9,2,7,22,0,1,0,1,0,3.3,1410,63
another_country,0,3,2,1,66,0,0,0,0,0,0,0,0
1032409-boy_meets_girl,0,1,1,0,100,0,0,0,0,0,0,0,0
1004370-cloak_and_dagger,5,5,2,3,40,0,0,0,0,0,0,0,0
1006510-electric_dreams,5.4,5,2,3,40,0,1,1,0,100,3.6,758,72
ice_pirates,3.9,9,1,8,11,0,0,0,0,0,0,0,0
racing_with_the_moon,6.1,10,6,4,60,0,3,3,0,100,3.3,795,57
times_of_harvey_milk,8.3,16,16,0,100,0,1,1,0,100,4.2,1883,93
what_have_i_done_to_deserve_this,7.6,6,6,0,100,0,1,1,0,100,3.8,1849,80
heaven_help_us,5.6,5,2,3,40,0,1,0,1,0,3.5,872,67
police_story,6.9,12,10,2,83,0,1,1,0,100,3.7,4759,84
mishima_a_life_in_four_chapters,7.4,20,19,1,95,0,2,2,0,100,4.2,932,91
quiet_earth,6.2,8,5,3,62,0,0,0,0,0,0,0,0
spies_like_us,4.6,18,8,10,44,0,0,0,0,0,0,0,0
stuff,6.1,8,5,3,62,0,1,0,1,0,3.1,1354,48
vision_quest,5.4,12,7,5,58,0,1,1,0,100,3.5,1468,71
white-nights,5.1,13,6,7,46,0,1,0,1,0,3.4,1109,74
round_midnight,8.1,17,17,0,100,8.3,6,6,0,100,4.1,809,88
1002178-best_of_times,4.7,12,4,8,33,0,1,0,1,0,2.9,1014,41
paradise-1986,0,0,0,0,0,0,0,0,0,0,0,0,0
1015224-nobodys_fool,0,4,0,4,0,0,1,0,1,0,3,289,43
1018055-sacrifice,7.2,25,20,5,80,0,4,3,1,75,4.4,1787,92
better_tomorrow,7.3,14,13,1,92,0,0,0,0,0,0,0,0
law_of_desire,7.4,11,11,0,100,0,2,2,0,100,3.8,1875,79
prince_of_darkness,5.1,19,9,10,47,0,1,0,1,0,3.3,3606,59
chinese_ghost_story,7.8,8,6,2,75,0,0,0,0,0,0,0,0
bourne_identity,7,180,148,32,82,6.9,37,30,7,81,3.9,125823,91
cobra_verde,6.9,14,12,2,85,0,3,2,1,66,3.7,950,74
killer_klowns_from_outer_space,5.6,13,9,4,69,0,0,0,0,0,0,0,0
cat-girl-kiki,0,0,0,0,0,0,0,0,0,0,0,0,0
monsieur_hire,8,11,11,0,100,0,2,2,0,100,3.9,441,84
almost_an_angel,3.9,7,2,5,28,0,1,0,1,0,0,0,0
black_rainbow,0,3,3,0,100,0,0,0,0,0,0,0,0
cry-baby,6.7,37,30,7,81,6.2,6,4,2,66,3.3,38084,75
1054247-bullet_in_the_head,8.4,5,5,0,100,0,0,0,0,0,0,0,0
new-york-beat-movie-downtown-81,5.7,21,15,6,71,6.7,8,7,1,87,3.7,653,71
ghost_dad,2.2,19,1,18,5,0,4,1,3,25,2.5,2569,38
hard_to_kill,3.7,10,3,7,30,0,1,0,1,0,2.7,4865,52
stephen-kings-it1990,5.6,10,7,3,70,0,0,0,0,0,0,0,0
ju_dou,8.3,14,14,0,100,0,3,3,0,100,3.9,1328,86
krays,6.4,12,10,2,83,0,2,2,0,100,3.7,1447,82
1032883-lionheart,4,11,3,8,27,0,3,1,2,33,3,2754,54
1030146-narrow_margin,6,11,7,4,63,0,2,0,2,0,3,630,42
nuns_on_the_run,4.7,18,8,10,44,0,2,1,1,50,2.9,1378,48
state_of_grace,6.8,15,13,2,86,0,2,2,0,100,3.7,2900,79
days_of_being_wild,7.7,29,26,3,89,8.1,13,12,1,92,4,3441,87
predator,6.8,37,28,9,75,0,4,2,2,50,3.5,52908,83
hearts_of_darkness_a_filmmakers_apocalypse,8.5,24,24,0,100,8.2,6,6,0,100,4.1,3043,90
1101255-kiss_before_dying,0,4,3,1,75,0,0,0,0,0,0,0,0
omohide_poro_poro,0,3,3,0,100,0,0,0,0,0,0,0,0
once_around,5.9,18,12,6,66,5.4,5,3,2,60,3.5,705,71
other_peoples_money,4.6,14,5,9,35,0,2,1,1,50,2.8,936,42
out_for_justice,3.6,20,4,16,20,0,4,1,3,25,3,3054,57
quigley_down_under,5.5,15,9,6,60,0,2,0,2,0,3.2,3350,67
tous_les_matins_du_monde,7.2,9,8,1,88,0,2,1,1,50,4.1,1291,87
diggstown,5.5,13,7,6,53,0,0,0,0,0,0,0,0
porco_rosso,8.2,12,12,0,100,0,0,0,0,0,0,0,0
ladybugs,3.7,13,2,11,15,0,1,0,1,0,2.6,2093,41
mambo_kings,6.6,19,15,4,78,0,2,2,0,100,3.3,1188,61
story_of_qiu_ju,8,14,12,2,85,0,2,1,1,50,3.9,768,83
shining_through,4.4,13,4,9,30,0,2,1,1,50,3.4,1160,71
sidekick,7.3,13,13,0,100,0,0,0,0,0,0,0,0
un_coeur_en_hiver,7.7,13,11,2,84,0,2,2,0,100,4.1,1098,88
house_of_angels,7.2,5,4,1,80,0,1,1,0,100,3.7,254,72
1144115-bad_boy_bubby,6.9,6,5,1,83,0,1,0,1,0,4,2270,87
bride_with_white_hair,8.1,7,7,0,100,0,0,0,0,0,0,0,0
barbarians_at_the_gate,6,6,4,2,66,0,0,0,0,0,0,0,0
1009583-hidden_fortress,8.6,22,22,0,100,0,2,2,0,100,4.1,6021,90
mr_nanny,2.4,14,1,13,7,0,3,0,3,0,2.3,4808,38
philadelphia_experiment_2,0,0,0,0,0,0,0,0,0,0,0,0,0
snapper,7.4,31,30,1,96,7.8,7,7,0,100,0,0,0
sonatine,7.3,24,21,3,87,6.4,6,4,2,66,0,0,0
splitting_heirs,3.8,12,1,11,8,0,2,0,2,0,2.6,577,34
tai-chi-warriors,0,0,0,0,0,0,0,0,0,0,0,0,0
freaked,5.4,15,7,8,46,0,1,1,0,100,3.3,1649,59
fist-of-legend,7.9,11,11,0,100,0,0,0,0,0,0,0,0
major_league_2,3.3,21,1,20,4,2.7,6,0,6,0,2.8,4428,45
pure_formality,7,5,4,1,80,0,1,0,1,0,4.2,605,91
gonin,6.8,6,5,1,83,0,0,0,0,0,0,0,0
1040678-last_of_the_mohicans,8,32,31,1,96,7.9,7,7,0,100,3.6,34073,84
whisper-of-the-heart,7.4,9,8,1,88,0,0,0,0,0,0,0,0
tromeo-and-juliet,0,3,2,1,66,0,0,0,0,0,0,0,0
god-of-cookery,0,3,3,0,100,0,0,0,0,0,0,0,0
kauas-pilvet-karkaavat-drifting-clouds-far-away-the-clouds-escape,7.1,9,9,0,100,7.2,5,5,0,100,4.1,737,90
sgt-kabukiman-nypd,0,0,0,0,0,0,0,0,0,0,0,0,0
beautiful_boxer,6.7,35,28,7,80,6.7,12,9,3,75,3.9,879,88
gummo,4.7,35,12,23,34,4.1,6,1,5,16,3.6,5657,76
hellcab,5.3,8,4,4,50,0,1,1,0,100,3.2,473,51
1082798-men_with_guns,7.6,26,23,3,88,0,4,4,0,100,3.9,476,84
1140962-nirvana,0,2,0,2,0,0,0,0,0,0,0,0,0
dance_with_the_devil,5.3,9,3,6,33,0,0,0,0,0,0,0,0
1097142-safe_house,0,1,0,1,0,0,0,0,0,0,0,0,0
10007916_interview,6,121,70,51,57,5.8,31,15,16,48,3.2,14637,53
thursday,3.9,6,2,4,33,0,0,0,0,0,0,0,0
lady-snowblood,0,2,2,0,100,0,0,0,0,0,0,0,0
takedown_2000,0,0,0,0,0,0,0,0,0,0,0,0,0
kirikou_and_the_sorceress,7.4,24,23,1,95,7.8,8,8,0,100,3.9,1078,85
taxi_2,0,3,2,1,66,0,0,0,0,0,0,0,0
wind_will_carry_us,8.4,25,24,1,96,0,4,4,0,100,3.9,888,82
2046,7.4,106,89,17,83,7.3,30,25,5,83,3.9,14211,84
1101319-taboo,6.6,21,14,7,66,0,2,2,0,100,3.5,1242,70
6ixtynin9,6.6,17,16,1,94,0,3,3,0,100,3.4,613,74
audition_1999,7,61,47,14,77,6.6,12,9,3,75,3.8,14430,81
1125456-hole,5.8,15,8,7,53,0,1,0,1,0,3.1,5670,58
sleeping_dictionary,0,3,0,3,0,0,0,0,0,0,0,0,0
kabhi-khushi-kabhie-gham,0,0,0,0,0,0,0,0,0,0,0,0,0
asterix-obelix-mission-cleopatre,6.3,7,6,1,85,0,1,0,1,0,3.6,4436,78
1136907-late_night_shopping,5.7,5,3,2,60,0,0,0,0,0,0,0,0
the-tunnel,6.9,25,21,4,84,6.9,12,10,2,83,4,713,92
laramie_project,7,12,11,1,91,0,1,1,0,100,3.7,1662,78
jsa-joint-security-area-aka-gongdong-gyeongbi-guyeok,6.9,12,9,3,75,0,3,1,2,33,4,2656,90
dagon,5.4,9,5,4,55,0,0,0,0,0,0,0,0
ripleys_game,7.2,21,20,1,95,0,4,4,0,100,3.4,2169,63
conspiracy,0,2,0,2,0,0,1,0,1,0,2.5,968,22
jalla-jalla-the-best-mans-wedding,5.4,8,4,4,50,0,1,0,1,0,3.7,1390,76
story-of-a-beautiful-country,0,0,0,0,0,0,0,0,0,0,0,0,0
darkness,2.7,52,2,50,3,2,11,0,11,0,2.6,4153,37
mockingbird_dont_sing,0,1,0,1,0,0,0,0,0,0,0,0,0
blueberry,4.2,7,2,5,28,0,0,0,0,0,0,0,0
shackletons-antarctic-adventure,0,0,0,0,0,0,0,0,0,0,0,0,0
1113170-pulse,6.8,48,35,13,72,6.4,14,10,4,71,3.3,3346,61
1131316-carolina,0,2,1,1,50,0,0,0,0,0,0,0,0
dog_days,5.4,33,16,17,48,6.5,11,7,4,63,3.6,603,70
my_sassy_girl,0,2,2,0,100,0,0,0,0,0,0,0,0
1023205-warriors,7.4,30,28,2,93,0,0,0,0,0,0,0,0
towelhead,5.3,110,52,58,47,5,33,16,17,48,3.4,2878,61
fubar,6.2,11,6,5,54,0,1,1,0,100,0,0,0
strange_faces_of_japanese_cinema,0,0,0,0,0,0,0,0,0,0,0,0,0
sex_is_comedy,6.4,46,32,14,69,6.5,19,12,7,63,3.1,1109,52
10003925-dead_end,6.1,7,6,1,85,0,0,0,0,0,0,0,0
sympathy-for-mr-vengeance-boksuneun-naui-geot,6.2,53,29,24,54,5.7,12,6,6,50,4,10632,86
1125611-suicide_club,5.7,6,3,3,50,0,0,0,0,0,0,0,0
1144306-immortal,5.1,7,3,4,42,0,0,0,0,0,0,0,0
battlestar-gallactica,0,1,1,0,100,0,0,0,0,0,0,0,0
sound_of_thunder,2.9,96,6,90,6,2.9,23,1,22,4,2.4,12447,24
fear_and_trembling,7.3,35,32,3,91,7.5,15,13,2,86,3.7,726,74
1133147-oasis,7.7,28,25,3,89,7.9,12,12,0,100,4,289,85
herr-lehmann-berlin-blues,0,0,0,0,0,0,0,0,0,0,0,0,0
remember_me_my_love,5.8,33,18,15,54,5.9,9,5,4,55,3.4,361,58
bright_young_things,6.3,107,70,37,65,6.5,32,21,11,65,3.5,1866,64
animatrix,6.7,17,15,2,88,0,1,1,0,100,3.4,35884,68
brown_bunny,5.1,89,39,50,43,4.8,30,13,17,43,2.9,2486,48
1114,6.8,11,11,0,100,0,1,1,0,100,3.6,6342,75
springtime-in-a-small-town,7.4,35,31,4,88,7.6,11,11,0,100,3.5,338,65
bring_it_on_again,0,0,0,0,0,0,0,0,0,0,0,0,0
1141488-crimson_rivers_2_angels_of_the_apocalypse,0,2,0,2,0,0,0,0,0,0,0,0,0
1157810-evil,6.6,36,24,12,66,5.8,11,5,6,45,3.9,2971,85
lemony_snicket,6.6,154,109,45,70,6.6,32,19,13,59,3.2,60437,61
green_butchers,6.3,27,17,10,62,5.6,12,5,7,41,3.9,1464,84
very_long_engagement,7.4,142,110,32,77,7.3,35,28,7,80,3.9,22939,84
last_life_in_the_universe,7.4,40,36,4,90,7.8,11,11,0,100,4.1,3086,89
punk-drunk-love-the-images-of-mick-rock,0,0,0,0,0,0,0,0,0,0,0,0,0
ghost_in_the_shell_2_innocence,6.3,94,61,33,64,6.4,24,17,7,70,3.8,8464,80
cat_returns,7,17,16,1,94,0,2,2,0,100,3.9,9609,81
in_my_country,4.8,81,18,63,22,5.1,28,6,22,21,3.3,748,59
te_doy_mis_ojos,7.6,33,30,3,90,7.2,11,9,2,81,3.6,1070,78
twilight_samurai,8.2,68,67,1,98,7.9,22,22,0,100,4.2,3512,93
facing_windows,6.1,65,41,24,63,6.2,27,19,8,70,4,1928,85
ginger_snaps_2_unleashed,6.9,15,14,1,93,0,3,3,0,100,3.2,5388,65
10003310-trauma,4.7,15,5,10,33,0,2,0,2,0,2.6,731,28
1132500-intimate_strangers,7.3,100,87,13,87,7.2,32,27,5,84,3.4,696,65
oldboy,7.3,127,102,25,80,7.1,30,24,6,80,4.3,41925,94
red_lights,7.2,85,71,14,83,7.4,31,26,5,83,3.4,433,64
ginger_snaps_back,0,4,3,1,75,0,0,0,0,0,0,0,0
lost_embrace,6.7,47,39,8,82,7.3,17,15,2,88,3.7,516,72
jacket,5.4,157,68,89,43,5.1,32,11,21,34,3.5,22896,72
20_million_miles_to_earth,6.4,8,7,1,87,0,0,0,0,0,0,0,0
saddest_music_in_the_world,7.1,99,77,22,77,6.9,27,20,7,74,3.7,1821,77
man_who_copied,6.2,32,21,11,65,5.4,12,5,7,41,3.9,896,83
ongbak,6.9,102,87,15,85,6.5,25,19,6,76,3.8,16639,85
sea_inside,7.6,128,107,21,83,7.5,36,29,7,80,4.1,10334,92
spanglish,5.9,162,85,77,52,5.8,40,21,19,52,3,21732,62
festival_express,7.6,76,73,3,96,7.7,28,28,0,100,3.8,857,79
chorus_les_choristes,6.5,105,71,34,67,6.3,29,18,11,62,4.1,8414,92
saints_and_soldiers,6.4,33,21,12,63,5.9,13,8,5,61,3.9,4284,81
story_of_the_weeping_camel,7.6,102,96,6,94,7.6,29,28,1,96,4,1514,84
interpreter,6,189,109,80,57,6.2,40,25,15,62,3.1,14657,56
open_water,6.6,189,136,53,71,7.1,38,30,8,78,2.4,8148,31
touch_of_pink,5,61,22,39,36,5,20,8,12,40,3.4,1401,63
memory_of_a_killer,6.8,67,56,11,83,6.9,22,19,3,86,3.7,1053,77
bobby_jones_stroke_of_genius,4.6,74,19,55,25,4.3,28,8,20,28,3.4,708,63
layer_cake,7.1,133,108,25,81,7.4,31,26,5,83,3.7,37167,83
the-return-2003,0,0,0,0,0,0,0,0,0,0,0,0,0
flight_of_the_phoenix,4.8,115,34,81,29,4.4,27,5,22,18,3,7566,48
mean_creek,7.3,117,105,12,89,7.5,35,32,3,91,3.6,5554,79
ring_two,4.4,178,36,142,20,4.7,37,10,27,27,2.8,39779,54
gospel_of_john,5,50,18,32,36,4.9,16,4,12,25,4.3,425,88
machuca,7.5,37,33,4,89,7.7,11,10,1,90,4.1,1842,90
corporation,7.4,107,97,10,90,7.6,30,28,2,93,4,5815,89
yes_men,7,82,70,12,85,6.8,28,22,6,78,3.4,1444,65
1140811-fond_kiss,7.4,24,21,3,87,0,4,4,0,100,3.7,1269,73
saa_som_i_himmelen,6.7,6,5,1,83,0,2,2,0,100,4.3,3319,90
she_hate_me,3.9,99,19,80,19,3.8,36,7,29,19,3.3,1915,61
azumi2003,5.4,32,15,17,46,4.5,11,3,8,27,3.9,4714,82
in_my_fathers_den,7.3,9,9,0,100,0,1,1,0,100,4.1,1184,90
taegukgi_the_brotherhood_of_war,6.7,41,33,8,80,6.6,17,14,3,82,4.2,5475,91
metallica_some_kind_of_monster,7.6,121,107,14,88,7.5,32,30,2,93,3.7,5021,83
10004352-going_the_distance,2.8,5,0,5,0,0,2,0,2,0,3.3,5047,61
redemption,0,0,0,0,0,0,0,0,0,0,0,0,0
schultze_gets_the_blues,6.8,63,45,18,71,7,20,14,6,70,3.5,678,71
born_into_brothels,7.9,105,101,4,96,7.9,29,27,2,93,4.2,4144,91
dig,7.8,69,62,7,89,7.9,21,19,2,90,4.1,2189,89
riding_giants,7.5,94,87,7,92,7.5,29,28,1,96,4.1,1482,93
word_wars,7.1,35,31,4,88,6.9,16,13,3,81,3.5,889,66
when_will_i_be_loved,4.6,71,23,48,32,4.3,27,7,20,25,2.6,695,31
what_the__do_we_know,4.6,75,25,50,33,4.7,24,10,14,41,3.5,5742,69
scanner_darkly,6.6,174,119,55,68,6.7,37,23,14,62,3.4,46764,70
10004734-casshern,6,9,6,3,66,0,0,0,0,0,0,0,0
outfoxed,6.9,59,50,9,84,6.9,18,16,2,88,3.7,1346,76
noel,4.3,34,9,25,26,3.1,12,0,12,0,3.3,1805,55
1209327-chimes_at_midnight,8,12,11,1,91,0,4,3,1,75,4.3,774,90
million_dollar_baby,8.3,224,204,20,91,8.6,40,38,2,95,3.8,64852,87
10004890-narrow_margin,8.3,7,7,0,100,0,0,0,0,0,0,0,0
hell_is_for_heroes,6.5,6,5,1,83,0,0,0,0,0,0,0,0
gozu,6.2,53,38,15,71,6,14,11,3,78,3.9,2732,81
goodbye-dragon-inn,7.5,33,27,6,81,7.5,11,10,1,90,3.6,632,70
hotel_rwanda,7.9,188,170,18,90,7.7,37,32,5,86,4,52962,94
sei-donne-per-lassassino-blood-and-black-lace-six-women-for-the-murderer,7.6,9,7,2,77,0,0,0,0,0,0,0,0
fly-thought-on-golden-wings,0,0,0,0,0,0,0,0,0,0,0,0,0
3-iron,7.3,87,75,12,86,7.2,24,19,5,79,4.3,7442,93
yves-st-laurent-his-life-and-times,6.3,14,10,4,71,5.9,9,6,3,66,3.8,65,81
aviator,7.8,212,185,27,87,7.5,44,36,8,81,3.4,27084,73
phantom_of_the_opera,5,165,54,111,32,4.6,37,10,27,27,3.7,70849,86
beyond_the_sea,5.2,150,63,87,42,5.1,34,14,20,41,3.3,3905,64
woodsman,7.3,129,112,17,86,7.5,34,31,3,91,3.5,4219,74
in_good_company,7.1,160,134,26,83,6.9,37,28,9,75,3,9983,51
meet_the_fockers,5.2,157,60,97,38,5.1,38,15,23,39,3.5,187397,63
assassination_of_richard_nixon,6.6,130,87,43,66,6.3,31,16,15,51,3.4,3593,67
love_song_for_bobby_long,5.5,98,42,56,42,5.3,27,12,15,44,3.7,5803,80
merchant_of_venice,6.7,123,88,35,71,6.8,35,24,11,68,3.5,4764,72
fat_albert,4.4,81,18,63,22,4.4,30,7,23,23,2.7,6431,53
chiavi_di_casa,6.9,25,20,5,80,7.4,7,6,1,85,3.7,367,75
in_the_realms_of_the_unreal,6.8,61,43,18,70,7,19,15,4,78,3.8,1043,77
white_noise,3.5,146,13,133,8,3.5,33,3,30,9,2.7,14878,44
underclassman,2.8,79,5,74,6,2.8,25,1,24,4,2.7,3200,44
upside_of_anger,6.8,168,125,43,74,6.5,34,23,11,67,3.2,4962,60
arrowhead,0,1,0,1,0,0,0,0,0,0,0,0,0
the-grateful-dead,0,0,0,0,0,0,0,0,0,0,0,0,0
last_train_from_gun_hill,0,4,3,1,75,0,0,0,0,0,0,0,0
naked_jungle,7,6,5,1,83,0,0,0,0,0,0,0,0
handful_of_dust,0,3,2,1,66,0,1,1,0,100,3,754,41
pickle,4.5,5,1,4,20,0,2,1,1,50,2.4,58,19
wetherby,7.6,5,4,1,80,0,1,1,0,100,3.1,194,43
powwow_highway,7.2,9,9,0,100,0,1,1,0,100,4,600,87
sweet_liberty,5.7,12,9,3,75,0,1,0,1,0,3,337,34
vie_promise,5.6,22,10,12,45,5.2,10,4,6,40,3.2,202,48
its_all_true,7,20,16,4,80,6.4,5,4,1,80,3.2,261,56
phantom_of_the_opera,5,165,54,111,32,4.6,37,10,27,27,3.7,70849,86
i_remember_mama,7.5,15,14,1,93,0,2,2,0,100,4,582,83
last_horror_movie,5.9,9,5,4,55,0,0,0,0,0,0,0,0
testament,7.2,7,6,1,85,0,1,1,0,100,3.7,455,70
smooth_talk,6.6,9,7,2,77,0,2,1,1,50,3.1,280,41
1005967-distant_thunder,5.2,6,3,3,50,0,1,1,0,100,3.1,151,37
hells_angels,7.3,10,9,1,90,0,0,0,0,0,0,0,0
jinxed,0,1,0,1,0,0,0,0,0,0,0,0,0
out_cold,2.9,48,4,44,8,3,15,1,14,6,3.5,7234,84
1138315-heart_of_america,0,4,1,3,25,0,0,0,0,0,0,0,0
show_of_force,0,0,0,0,0,0,0,0,0,0,0,0,0
man_trouble,3.7,11,2,9,18,0,1,0,1,0,2.6,637,17
yakuza_papers_battles_without_honor_and_humanity,6.5,6,3,3,50,0,0,0,0,0,0,0,0
fuehrer_ex,0,1,0,1,0,0,0,0,0,0,0,0,0
stander,6.5,62,45,17,72,6.5,16,12,4,75,3.6,1039,77
hester_street,6.2,6,4,2,66,0,0,0,0,0,0,0,0
mikey_and_nicky,6.4,11,8,3,72,0,0,0,0,0,0,0,0
bigamist,0,2,2,0,100,0,0,0,0,0,0,0,0
libertarias_1996,0,0,0,0,0,0,0,0,0,0,0,0,0
imaginary_heroes,5.2,101,35,66,34,5,30,11,19,36,3.8,3294,80
sergeant_york,6.9,18,15,3,83,0,2,1,1,50,4,1263,87
taistoi,0,1,1,0,100,0,0,0,0,0,0,0,0
day_of_the_wacko,0,2,2,0,100,0,0,0,0,0,0,0,0
wizard,4.3,17,4,13,23,0,3,0,3,0,3.1,3783,60
abbott_and_costello_meet_the_invisible_man,5.5,8,6,2,75,0,0,0,0,0,0,0,0
abbott_and_costello_meet_the_killer,0,0,0,0,0,0,0,0,0,0,0,0,0
1142298-life_and_death_of_peter_sellers,6.2,19,14,5,73,0,3,1,2,33,3.4,2594,69
1144029-appleseed,4.7,32,8,24,25,4.4,14,2,12,14,3.7,5608,76
1013912-milky_way,7.7,14,13,1,92,0,2,2,0,100,4,669,84
many_adventures_of_winnie_the_pooh,8.1,11,10,1,90,0,1,1,0,100,3.6,3913,81
elektra,3.7,150,15,135,10,3.8,33,4,29,12,2.6,26366,47
racing_stripes,4.9,98,34,64,34,5.1,25,12,13,48,3,10332,56
coach_carter,6.1,142,92,50,64,6,35,21,14,60,3.7,56395,85
sullivans_travels,8.7,29,29,0,100,0,2,2,0,100,4.2,2289,90
1010362-iceman,0,1,1,0,100,0,0,0,0,0,0,0,0
ice_station_zebra,5.3,12,6,6,50,0,1,0,1,0,3.2,1042,53
boys_town,7.1,14,14,0,100,0,0,0,0,0,0,0,0
1155730-torremolinos_73,6.4,40,28,12,70,6.7,20,15,5,75,3.5,502,68
1021211-shivers,6.8,19,16,3,84,0,2,1,1,50,3.4,2264,61
rocco_and_his_brothers,7.8,17,16,1,94,0,4,3,1,75,4.2,1288,92
christmas_in_july,7.9,16,15,1,93,0,4,3,1,75,4,244,87
i_married_a_witch,7.7,14,14,0,100,0,2,2,0,100,3.7,260,67
moolaad,0,0,0,0,0,0,0,0,0,0,0,0,0
1139947-this_girls_life,5.6,7,3,4,42,0,1,1,0,100,3.1,508,47
memories-of-murder,7.7,34,30,4,88,7.9,9,9,0,100,4.2,3096,93
1049183-chase,4.8,16,5,11,31,0,3,0,3,0,2.6,2631,36
1156285-summer_storm,5.7,30,15,15,50,5.7,13,7,6,53,3.8,1586,80
joseph-the-man-closest-to-christ2007,0,0,0,0,0,0,0,0,0,0,0,0,0
assault_on_precinct_13,5.9,160,96,64,60,6,36,23,13,63,3.1,12635,54
1141102-are_we_there_yet,3.3,113,13,100,11,3.6,32,3,29,9,3.1,29416,62
alone_in_the_dark,1.7,116,1,115,0,1.7,26,0,26,0,2.1,8641,21
1141193-hide_and_seek,3.8,153,19,134,12,4.3,35,6,29,17,3.1,22573,60
aliens_of_the_deep,7,61,51,10,83,7.5,21,18,3,85,3.2,1182,50
boogeyman,3.4,85,11,74,12,3.2,11,0,11,0,2.5,13866,38
wedding_date,3.8,136,14,122,10,3.9,31,3,28,9,3.2,34530,68
rory_o_shea_was_here,5.8,69,34,35,49,5.6,21,9,12,42,4.1,2819,89
nobody_knows,8,91,85,6,93,8.4,28,27,1,96,4.2,3440,92
employee_of_the_month,4,88,18,70,20,3.9,25,4,21,16,3.2,54090,61
magic_in_the_water,3.6,8,1,7,12,0,2,0,2,0,3.3,642,59
great_white_hope,5.5,6,2,4,33,0,3,1,2,33,3.8,213,74
professional,6.8,39,30,9,76,5.8,8,4,4,50,4.1,59011,94
1137476-everyday_people,6.3,8,6,2,75,0,4,4,0,100,2.9,87,41
the-brd-trilogy-the-marriage-of-maria-braun,8.5,14,13,1,92,0,3,3,0,100,4.1,858,89
beau_geste,8.1,9,9,0,100,0,0,0,0,0,0,0,0
1125456-hole,5.8,15,8,7,53,0,1,0,1,0,3.1,5670,58
lessons-of-darkness,8,9,9,0,100,0,0,0,0,0,0,0,0
double_dragon,3.2,10,0,10,0,0,3,0,3,0,2.1,3610,29
mac_and_me,2.4,14,0,14,0,0,2,0,2,0,2.7,2264,43
scorchers,0,0,0,0,0,0,0,0,0,0,0,0,0
rosenstrasse,5.8,61,34,27,55,5.6,25,13,12,52,3.5,359,66
casque_dor,8.4,11,11,0,100,0,3,3,0,100,3.7,397,76
grisbi,8.3,23,23,0,100,8.8,7,7,0,100,4,630,83
1079208-matchmaker,5.6,26,14,12,53,0,4,2,2,50,3.3,1220,66
ballad_of_the_sad_cafe,6.4,5,4,1,80,0,3,2,1,66,3.6,69,64
deceivers,5.1,5,1,4,20,0,1,0,1,0,3.1,252,50
purple_butterfly,5.5,20,9,11,45,5.8,8,4,4,50,3.1,578,42
five_easy_pieces,8.2,30,25,5,83,6.5,5,3,2,60,3.9,4148,85
el_cid,6.5,12,11,1,91,0,1,1,0,100,3.6,1234,73
howls_moving_castle,7.5,148,127,21,85,7.3,36,30,6,83,4.1,56005,93
steamboy,6,87,51,36,58,6.1,28,16,12,57,3.5,4805,70
nomi_song,7.2,36,34,2,94,7.3,15,15,0,100,3.8,302,79
hitch,6.3,178,122,56,68,6.3,34,21,13,61,3.4,189230,65
poohs_heffalump_movie,6.6,84,67,17,79,6.2,23,17,6,73,3.5,2927,71
1211777-uncle_nino,4.4,33,7,26,21,4.2,13,3,10,23,3.7,109,70
bride_and_prejudice,6.1,131,84,47,64,6.8,32,26,6,81,3.3,17555,67
constantine,5.5,214,98,116,45,4.7,42,10,32,23,3.5,71421,75
son_of_the_mask,2.8,101,6,95,5,3.1,25,0,25,0,2.1,4576,32
because_of_winndixie,5.8,118,63,55,53,5.8,31,17,14,54,3.3,6908,70
turtles_can_fly,7.8,70,62,8,88,7.7,21,19,2,90,4.3,2998,93
beautiful_boxer,6.7,35,28,7,80,6.7,12,9,3,75,3.9,879,88
pauly-shore-is-dead,5.7,13,8,5,61,0,1,1,0,100,2.4,2127,28
bunny_lake_is_missing,6.9,9,8,1,88,0,1,1,0,100,3.7,715,76
jeremy,0,1,1,0,100,0,0,0,0,0,0,0,0
dont_tell_her_its_me,0,1,1,0,100,0,0,0,0,0,0,0,0
until_september,3.3,5,0,5,0,0,2,0,2,0,3.5,159,63
1040890-night_and_the_city,5.7,10,6,4,60,0,2,1,1,50,3,376,33
frozen-land-paha-maa,0,0,0,0,0,0,0,0,0,0,0,0,0
1148279-night_watch,5.9,125,73,52,58,5.9,30,17,13,56,3.3,19774,70
dot_the_i,4.6,59,15,44,25,4.6,23,4,19,17,3.8,2535,78
road_to_morocco,7.8,12,11,1,91,0,0,0,0,0,0,0,0
man_of_the_house,3.3,60,5,55,8,3.9,16,4,12,25,3.1,10877,59
kung_fu_hustle,7.6,172,154,18,89,7.4,39,33,6,84,3.6,37633,86
1139436-zelary,6.7,51,37,14,72,6.6,15,11,4,73,4.1,638,89
dr_giggles,3.9,14,3,11,21,0,0,0,0,0,0,0,0
1046772-three_musketeers,4.8,24,7,17,29,0,3,0,3,0,3.2,13783,67
four_feathers,5.4,149,61,88,40,5.6,32,13,19,40,3.2,6869,65
curse_of_the_demon,8,10,10,0,100,0,0,0,0,0,0,0,0
kontroll,7,64,52,12,81,6.6,18,13,5,72,4,2770,88
5x2,6.2,68,44,24,64,6,20,12,8,60,3.6,1684,69
germania-anno-zero-germany-year-zero,9.2,9,9,0,100,0,0,0,0,0,0,0,0
hole_in_my_heart,4,17,7,10,41,3.6,8,2,6,25,2.8,704,39
bigger_than_the_sky,3.6,16,2,14,12,3.2,9,0,9,0,3.1,458,51
diary_of_a_mad_black_woman,3.9,108,17,91,15,4.4,30,8,22,26,4,28144,89
you-must-kill,0,0,0,0,0,0,0,0,0,0,0,0,0
in_the_loop,7.8,158,148,10,93,7.7,29,27,2,93,2.9,31450,76
pacifier,3.7,127,26,101,20,3.4,32,5,27,15,3.2,48314,70
be_cool,4.6,168,50,118,29,4.2,38,6,32,15,2.8,15817,48
gunner_palace,7,102,86,16,84,7.2,32,27,5,84,3.4,649,63
walk_on_water,6.5,74,53,21,71,6.1,23,15,8,65,4,1438,86
1141099-hostage,5,154,54,100,35,4.3,36,6,30,16,3.3,22771,69
domain-of-murder,0,0,0,0,0,0,0,0,0,0,0,0,0
laughing_policeman,5.9,5,4,1,80,0,1,1,0,100,3.1,219,43
1034008-class_action,6.1,23,17,6,73,0,4,4,0,100,3,742,45
1003747-cat_and_the_canary,6.9,6,5,1,83,0,0,0,0,0,0,0,0
courage_mountain,0,0,0,0,0,0,0,0,0,0,0,0,0
kiss-the-bride,5.4,6,2,4,33,0,0,0,0,0,0,0,0
godzilla_vs_the_sea_monster,0,2,1,1,50,0,0,0,0,0,0,0,0
godzilla-vs-mechagodzilla-ii,0,2,2,0,100,0,0,0,0,0,0,0,0
1021128-that_championship_season,6.2,5,3,2,60,0,0,0,0,0,0,0,0
1077310-dna,0,1,0,1,0,0,0,0,0,0,0,0,0
acid-drinkers-15-screwed-years2004,0,0,0,0,0,0,0,0,0,0,0,0,0
oh_god_you_devil,5.1,7,2,5,28,0,0,0,0,0,0,0,0
deus-e-brasileiro-god-is-brazilian,0,0,0,0,0,0,0,0,0,0,0,0,0
blackball,4.8,13,5,8,38,0,0,0,0,0,0,0,0
agony_and_the_ecstasy,7,5,5,0,100,0,0,0,0,0,0,0,0
return_to_peyton_place,0,1,0,1,0,0,0,0,0,0,0,0,0
butch-and-sundance-the-early-days,0,0,0,0,0,0,0,0,0,0,0,0,0
it_happened_to_jane,0,2,0,2,0,0,0,0,0,0,0,0,0
once_upon_a_forest,4.4,5,0,5,0,0,2,0,2,0,3.3,913,67
hello_down_there,0,2,2,0,100,0,0,0,0,0,0,0,0
all_in_a_nights_work,0,0,0,0,0,0,0,0,0,0,0,0,0
twentieth_century,7.7,24,21,3,87,0,2,2,0,100,3.7,487,74
10008742-my_sister_eileen,6.6,5,4,1,80,0,1,1,0,100,3.7,99,73
strangers_when_we_meet,0,4,3,1,75,0,0,0,0,0,0,0,0
chronicles_of_narnia_prince_caspian,6.3,179,120,59,67,6.2,37,23,14,62,3.8,154104,78
1008931-green_berets,3.5,8,2,6,25,0,0,0,0,0,0,0,0
elevator_to_the_gallows,8,41,38,3,92,8.1,14,13,1,92,4.2,1819,91
thriller_a_cruel_picture,4.3,5,2,3,40,0,1,0,1,0,3.5,1247,67
1139738-cube_zero,0,3,3,0,100,0,0,0,0,0,0,0,0
being_julia,6.7,123,94,29,76,6.5,35,24,11,68,3.5,1947,71
10004650-save_the_green_planet,7.3,38,33,5,86,7.4,12,11,1,91,4,1746,86
thirty_seconds_over_tokyo,0,4,4,0,100,0,0,0,0,0,0,0,0
boys_and_girl_from_county_clare,5.9,28,13,15,46,5.8,11,4,7,36,3.4,443,67
ice_princess,5.6,102,53,49,51,5.4,29,14,15,48,3.1,33981,66
melinda_and_melinda,5.8,154,82,72,53,6,39,22,17,56,3.1,2565,45
miss_congeniality_2,4,144,21,123,14,4,33,3,30,9,3,34010,59
guess_who,5.4,148,64,84,43,4.7,36,9,27,25,3.1,27344,59
debs,4.7,58,23,35,39,4.7,21,8,13,38,2.9,4690,52
league_of_ordinary_gentlemen,7.3,34,31,3,91,7.2,14,13,1,92,3.5,155,64
incident_at_loch_ness,6.2,47,29,18,61,5.5,16,7,9,43,3.4,894,66
frozen_river,7.3,125,109,16,87,7.9,26,24,2,92,3.2,9338,71
yanks,5.9,7,5,2,71,0,0,0,0,0,0,0,0
paradise_alley,0,4,1,3,25,0,0,0,0,0,0,0,0
seagulls_laughter,6.7,32,27,5,84,7.3,12,11,1,91,3.4,199,64
caballos-salvajes,0,0,0,0,0,0,0,0,0,0,0,0,0
woman_thou_art_loosed,5.5,56,29,27,51,5.4,23,12,11,52,4,869,86
arrowsmith,7.1,6,5,1,83,0,0,0,0,0,0,0,0
barbary_coast,7.4,10,10,0,100,0,2,2,0,100,3.1,211,43
stella_dallas,6.2,5,4,1,80,0,0,0,0,0,0,0,0
thief_and_the_cobbler,0,4,1,3,25,0,1,0,1,0,3.7,1335,74
free_radicals,6.4,16,10,6,62,7.1,5,4,1,80,3.2,206,50
come_and_get_it,7.5,9,8,1,88,0,2,2,0,100,3.1,281,48
panic_in_the_streets,7.3,18,17,1,94,0,2,2,0,100,3.5,554,72
call_northside_777,7.2,15,11,4,73,0,1,0,1,0,3.5,657,70
young-torless,0,0,0,0,0,0,0,0,0,0,0,0,0
bells_are_ringing,6.8,8,6,2,75,0,0,0,0,0,0,0,0
finians_rainbow,5.6,11,6,5,54,0,4,2,2,50,3.3,1023,57
toolbox_murders,5.9,15,7,8,46,0,1,1,0,100,2.8,1770,36
sword_of_doom,6.9,7,5,2,71,0,0,0,0,0,0,0,0
deep-crimson1997,0,0,0,0,0,0,0,0,0,0,0,0,0
800_balas,5.8,11,5,6,45,5.6,5,2,3,40,3.2,1505,56
attack_of_the_mushroom_people,0,3,2,1,66,0,0,0,0,0,0,0,0
ucarmen-ekhayelitsha,7.4,20,19,1,95,7.8,7,7,0,100,3.2,1204,50
1148583-pom_poko,7,5,4,1,80,0,0,0,0,0,0,0,0
knockin-on-heavens-door,0,0,0,0,0,0,0,0,0,0,0,0,0
1023286-were_no_angels,5.1,18,9,9,50,0,1,1,0,100,2.9,2176,43
earrings_of_madame_de,8.7,22,22,0,100,7.7,5,5,0,100,4.3,591,94
wild_parrots_of_telegraph_hill,7.7,94,89,5,94,7.7,28,28,0,100,3.9,1161,83
ballad_of_jack_and_rose,5.7,110,51,59,46,5.6,34,15,19,44,3.4,2469,64
1139289-beauty_shop,5.3,114,43,71,37,5.8,28,14,14,50,3.3,11288,70
look_at_me,7.6,98,85,13,86,8,31,29,2,93,3.5,1003,66
dust_to_glory,6.2,68,41,27,60,6,21,12,9,57,4.2,728,86
1144274-sahara,5.2,171,66,105,38,5,34,15,19,44,3,24489,61
fever_pitch,6.2,172,110,62,63,6,38,19,19,50,3,14004,62
winter_solstice,6.4,80,48,32,60,6.8,25,18,7,72,3,420,44
10005057-smile,4,13,2,11,15,3.9,5,1,4,20,3.5,585,69
sinbad_and_the_eye_of_the_tiger,6,8,5,3,62,0,0,0,0,0,0,0,0
not_on_the_lips,7.1,8,6,2,75,0,2,2,0,100,3.1,663,48
krakatoa_east_of_java,3.7,6,0,6,0,0,0,0,0,0,0,0,0
rhinestone,2.8,9,1,8,11,0,1,0,1,0,2.5,1290,37
electra_glide_in_blue,6.2,8,6,2,75,0,0,0,0,0,0,0,0
bring-on-the-night,0,0,0,0,0,0,0,0,0,0,0,0,0
special_day,0,2,2,0,100,0,0,0,0,0,0,0,0
lhomme-qui-plantait-des-arbres-the-man-who-planted-trees,0,0,0,0,0,0,0,0,0,0,0,0,0
gold-digger-killer,0,0,0,0,0,0,0,0,0,0,0,0,0
blind_horizon,0,4,2,2,50,0,0,0,0,0,0,0,0
1010762-islands_in_the_stream,6.3,5,4,1,80,0,0,0,0,0,0,0,0
1008429-go_for_broke,0,4,1,3,25,0,0,0,0,0,0,0,0
1001806-battle_of_the_bulge,6.7,6,4,2,66,0,0,0,0,0,0,0,0
ringu-0,0,2,1,1,50,0,0,0,0,0,0,0,0
1144988-brothers,7.5,71,63,8,88,7.8,24,22,2,91,3.8,1141,84
1009293-hawaii,0,1,0,1,0,0,0,0,0,0,0,0,0
deserto_rosso,8.4,11,11,0,100,0,2,2,0,100,4.1,1182,86
sexmission,0,0,0,0,0,0,0,0,0,0,0,0,0
waterloo_bridge,6.4,5,4,1,80,0,1,1,0,100,4,1003,88
with_six_you_get_eggroll,0,2,2,0,100,0,0,0,0,0,0,0,0
the-big-day-jour-de-fete,8.2,13,13,0,100,0,1,1,0,100,4,736,83
big_store,5.3,9,6,3,66,0,0,0,0,0,0,0,0
my_name_is_ivan,8.6,9,9,0,100,0,1,1,0,100,4.2,1542,93
1201493-chant_of_jimmie_blacksmith,0,3,3,0,100,0,0,0,0,0,0,0,0
let_him_have_it,7.3,12,11,1,91,0,1,1,0,100,3.9,381,83
sunshine_cleaning,6.3,158,112,46,70,6.4,34,26,8,76,3.3,81677,59
eiger_sanction,6.4,12,9,3,75,0,1,1,0,100,0,0,0
f-for-fake,7.3,24,21,3,87,0,3,3,0,100,4.1,1945,89
amityville_horror,4.2,155,37,118,23,3.9,33,7,26,21,3.2,31070,64
act_of_violence,6.8,10,9,1,90,0,2,2,0,100,3.8,227,78
napola_elite_fur_den_fuhrer,6.5,38,26,12,68,6.6,13,9,4,69,3.9,1085,86
frisco_kid,5.8,14,8,6,57,0,1,0,1,0,3.3,1432,60
state_property_two,3.5,14,2,12,14,4,10,2,8,20,3.9,1114,82
year_of_the_yao,6.2,32,21,11,65,6.1,11,7,4,63,3.6,562,67
house_of_d,3.8,101,10,91,9,3.6,29,2,27,6,3.6,2769,74
palindromes,5.3,113,47,66,41,5.7,34,16,18,47,3.5,3088,70
lot_like_love,4.9,123,50,73,40,5,33,12,21,36,3.5,20461,76
kings_ransom,2.4,50,1,49,2,2.2,14,0,14,0,2.7,933,37
miracle_match,0,0,0,0,0,0,0,0,0,0,0,0,0
bridges_of_madison_county,7.2,40,36,4,90,7.9,9,9,0,100,3.6,11573,83
xxx2_state_of_the_union,3.8,135,22,113,16,3.9,31,4,27,12,2.9,20840,53
kingdom_of_heaven,5.5,185,72,113,38,5.9,37,19,18,51,3.5,82821,72
house_of_wax,4.3,148,37,111,25,4.5,30,6,24,20,2.8,39495,54
1144992-crash,7.1,197,148,49,75,7.1,39,30,9,76,4,98746,89
jiminy-glick-in-la-la-wood,4.6,44,10,34,22,4.7,19,4,15,21,2.6,694,31
mysterious_skin,7.2,99,83,16,83,7.6,29,26,3,89,4,9458,89
1013984-mischief,5.2,5,3,2,60,0,0,0,0,0,0,0,0
jubal,0,4,4,0,100,0,0,0,0,0,0,0,0
viva_maria,0,2,0,2,0,0,0,0,0,0,0,0,0
san_francisco,7.4,7,7,0,100,0,0,0,0,0,0,0,0
buying-the-cow,0,3,1,2,33,0,0,0,0,0,0,0,0
cocoanuts,7.5,19,18,1,94,0,2,2,0,100,3.6,1293,71
kids_return,0,4,4,0,100,0,0,0,0,0,0,0,0
off-the-map,6.6,92,64,28,69,6.6,26,18,8,69,3.8,818,82
crackerjack-molloy-boy-productions,6.5,5,5,0,100,0,0,0,0,0,0,0,0
dear_wendy,5.1,60,22,38,36,4.2,16,3,13,18,3.2,7054,54
1145385-unleashed,6.2,128,83,45,64,5.9,31,15,16,48,3.5,17781,77
leolo,8.3,9,9,0,100,0,3,3,0,100,4.1,1393,87
star_wars_3,7.2,253,202,51,79,6.6,43,29,14,67,3.1,198824,64
kicking_and_screaming,5.1,137,57,80,41,5,31,12,19,38,3,14260,51
monsterinlaw,4.2,162,26,136,16,3.9,40,5,35,12,3.2,50840,63
1090759-deep_blue_sea,5.7,89,51,38,57,5.8,22,14,8,63,2.8,26286,44
1143677-snow_walker,6.8,13,11,2,84,0,3,2,1,66,3.7,895,76
divorce_italian_style,7.9,16,16,0,100,7.8,5,5,0,100,4,1181,90
9_songs,4.4,92,23,69,25,4.5,29,8,21,27,2.7,3152,35
nabbeun-namja-bad-guy,5.2,31,13,18,41,5,10,3,7,30,3.6,1440,72
1157813-simon,5.6,5,3,2,60,0,4,2,2,50,4.1,338,87
december-7th-1942,0,0,0,0,0,0,0,0,0,0,0,0,0
madagascar,6,185,102,83,55,6,36,14,22,38,3.4,131512,70
somersault,6.9,64,53,11,82,6.8,18,15,3,83,3.2,9811,53
1046035-airborne,2.9,6,1,5,16,0,1,0,1,0,0,0,0
mad_hot_ballroom,7.1,115,96,19,83,7.5,32,31,1,96,3.8,2138,80
dominion_prequel_to_the_exorcist,4.7,43,13,30,30,4.7,15,4,11,26,2.7,5628,35
longest_yard,4.8,163,51,112,31,5.2,35,14,21,40,3.3,198675,67
saving_face,6.7,81,70,11,86,7,25,23,2,92,4,2669,87
cinderella_man,7.4,206,164,42,79,7.6,43,35,8,81,3.8,44272,88
sisterhood_of_the_traveling_pants,6.7,128,98,30,76,7.2,31,29,2,93,3.4,38616,78
lords_of_dogtown,6,141,77,64,54,6.5,33,20,13,60,3.6,15495,81
apres-vous,6,64,36,28,56,6.3,20,12,8,60,3.5,850,67
school_of_rock,7.8,188,172,16,91,8.2,39,38,1,97,3.2,183700,63
mr_and_mrs_smith,6,202,116,86,57,5.6,39,18,21,46,3.4,230941,63
the-adventures-of-sharkboy-and-lavagirl-in-3d,4.3,120,24,96,20,4,31,5,26,16,2.5,5829,42
high-tension-switchblade-romance,5.2,126,52,74,41,4.9,24,11,13,45,3.4,11124,68
1146572-honeymooners,3.6,109,15,94,13,3.6,30,4,26,13,2.8,2118,42
10005381-parineeta,0,2,2,0,100,0,1,1,0,100,3.8,1102,81
ladies_in_lavender,6.1,89,56,33,62,6.3,27,17,10,62,3.5,2044,65
its_all_gone_pete_tong,6.5,70,54,16,77,6.1,21,14,7,66,3.9,3974,87
innocent_voices,6.8,47,32,15,68,7.1,16,11,5,68,4.3,1831,93
1017021-quo_vadis,6.4,8,7,1,87,0,0,0,0,0,0,0,0
batman_begins,7.7,257,217,40,84,6.6,43,26,17,60,3.9,184482,90
perfect_man,3.2,117,6,111,5,3.5,31,3,28,9,3.2,49341,69
my_summer_of_love,7.4,87,78,9,89,7.8,30,29,1,96,3.5,3593,69
heights,6.3,101,65,36,64,5.8,29,16,13,55,3.6,1284,73
1190825-deal,0,4,2,2,50,0,2,0,2,0,2.7,714,28
10002635-bridge_of_san_luis_rey,2.9,24,1,23,4,2.8,11,0,11,0,2.7,689,34
10005178-saint_ralph,6.3,67,42,25,62,6.1,24,15,9,62,3.8,1289,83
herbie_fully_loaded,5.4,139,58,81,41,5.6,32,15,17,46,2.8,18840,54
yes_man,5.2,144,62,82,43,4.9,31,12,19,38,3.7,141478,72
land_of_the_dead,6.6,169,124,45,73,6.4,32,21,11,65,3.1,28194,56
bewitched,4.6,182,44,138,24,4.3,41,8,33,19,2.5,17310,39
rize,7,89,74,15,83,7,29,25,4,86,4,2579,84
me_and_you_and_everyone_we_know,7.4,108,88,20,81,7.6,35,29,6,82,3.9,12252,85
threeextremes,6.8,62,52,10,83,6.5,23,16,7,69,3.7,5014,75
edukators,6.5,75,52,23,69,6.4,22,14,8,63,4,6418,89
somebody_up_there_likes_me,6.7,10,8,2,80,0,3,3,0,100,3.9,753,86
cop_and_a_half,2.8,12,2,10,16,0,2,1,1,50,2.3,1861,33
room_service,5.8,10,7,3,70,0,0,0,0,0,0,0,0
at_the_circus,6.9,9,9,0,100,0,0,0,0,0,0,0,0
war_of_the_worlds,7,244,178,66,72,6.7,42,28,14,66,2.9,162092,45
billion_dollar_brain,0,4,2,2,50,0,1,0,1,0,3.1,957,45
march_of_the_penguins,7.8,163,153,10,93,7.6,38,35,3,92,3.5,18536,76
rebound,3.7,89,12,77,13,4,29,4,25,13,2.9,5853,52
dark_water,5.5,148,67,81,45,5.3,36,15,21,41,2.7,18535,38
beat_that_my_heart_skipped,7.2,91,77,14,84,6.9,28,22,6,78,3.9,3473,83
fantastic_four,4.5,200,54,146,27,4.7,34,10,24,29,3.2,95962,57
murderball,8.4,137,134,3,97,8.4,35,35,0,100,3.9,3228,87
saraband,7.9,78,73,5,93,8.2,26,24,2,92,3.9,1427,83
julie-johnson,0,0,0,0,0,0,0,0,0,0,0,0,0
wedding_crashers,6.7,180,135,45,75,6.9,38,28,10,73,3.5,215271,70
happy_endings,6,104,58,46,55,6,33,16,17,48,3.4,3035,63
chomps,0,2,0,2,0,0,0,0,0,0,0,0,0
1009649-hindenburg,5.1,11,5,6,45,0,1,0,1,0,3,497,40
staying_together,5.8,5,4,1,80,0,1,0,1,0,3.2,295,61
twin_sitters,0,0,0,0,0,0,0,0,0,0,0,0,0
russian_dolls,6.6,47,34,13,72,6.8,17,11,6,64,3.6,8145,76
hustle_and_flow,7.3,153,126,27,82,7.5,37,30,7,81,3.6,17513,80
hardware,6.1,9,5,4,55,0,1,0,1,0,3.2,1157,60
10008785-appaloosa,6.6,156,119,37,76,6.6,34,25,9,73,3.2,19629,55
island,5.4,184,74,110,40,5.2,36,14,22,38,3.3,41199,67
1001567-bad_news_bears,7.4,24,22,2,91,7.2,5,5,0,100,3.3,4926,74
devils_rejects,5.4,131,70,61,53,5.4,27,13,14,48,3.6,27834,79
last_days,5.9,111,64,47,57,6,35,23,12,65,3.1,5692,53
v_for_vendetta,6.8,233,169,64,72,6.2,37,23,14,62,3.9,226041,88
1142872-sky_high,6.5,124,90,34,72,6.6,27,18,9,66,3,28338,58
1146673-1146673-stealth,3.8,138,18,120,13,3.6,31,2,29,6,2.9,14786,50
must_love_dogs,5,145,50,95,34,5,32,11,21,34,3,16710,57
conjure,0,0,0,0,0,0,0,0,0,0,0,0,0
twice_in_a_lifetime,7.4,6,5,1,83,0,1,1,0,100,3,200,45
georgy_girl,7.1,9,8,1,88,0,0,0,0,0,0,0,0
serenity,7.1,176,143,33,81,7.1,33,28,5,84,3.8,60506,89
broken_flowers,7.4,184,160,24,86,7.4,40,34,6,85,3.3,21466,68
1055873-browning_version,6.7,16,13,3,81,0,3,1,2,33,3.5,322,63
the-heart-is-deceitful-above-all-things,5,49,20,29,40,3,15,1,14,6,3.6,2672,70
dukes_of_hazzard,3.6,164,22,142,13,3.7,37,8,29,21,2.9,27455,58
chumscrubber,4.9,58,20,38,34,4.8,8,3,5,37,3.5,6925,76
secuestro_express,5.7,42,22,20,52,6.2,13,8,5,61,3.2,1109,73
junebug,7.5,126,108,18,85,7.8,33,31,2,93,3.4,7517,72
deuce_bigelow_european_gigolo,2.8,100,10,90,10,3,24,2,22,8,2.7,16038,51
1149472-skeleton_key,5.3,147,56,91,38,5,33,8,25,24,3.1,23528,63
hard-four,0,0,0,0,0,0,0,0,0,0,0,0,0
great_raid,5.3,119,43,76,36,4.9,28,8,20,28,3.6,3417,73
10009261-asylum,0,2,0,2,0,0,1,0,1,0,2.2,1071,17
pretty_persuasion,5,76,25,51,32,4.4,27,4,23,14,3.4,2958,64
grizzly_man,8,134,125,9,93,8.3,35,35,0,100,3.6,9472,82
1135414-24th_day,3.7,14,3,11,21,3.8,8,2,6,25,3.4,768,60
prime_cut,5.8,10,7,3,70,0,1,1,0,100,3.3,584,60
best_of_everything,0,4,2,2,50,0,0,0,0,0,0,0,0
three_stooges_meet_hercules,0,3,0,3,0,0,0,0,0,0,0,0,0
race_with_the_devil,5,5,2,3,40,0,0,0,0,0,0,0,0
acacia_2004,0,0,0,0,0,0,0,0,0,0,0,0,0
my_date_with_drew,6,64,45,19,70,5.7,21,14,7,66,3.1,2652,53
duma,7.5,59,55,4,93,7.4,25,23,2,92,3.3,11201,57
40_year_old_virgin,7.2,179,153,26,85,7.1,36,31,5,86,3.6,141534,81
1149496-1149496-red_eye,6.7,178,141,37,79,7.2,37,33,4,89,3.2,32710,66
man_of_the_west,8.7,6,6,0,100,0,0,0,0,0,0,0,0
nightmare_on_elm_street_5_the_dream_child,4.1,27,8,19,29,0,4,1,3,25,2.9,17837,56
1153493-cache,7.8,128,113,15,88,8.2,31,29,2,93,3.5,16387,71
valiant,5,109,33,76,30,4.6,25,3,22,12,2.8,6330,39
brothers_grimm,5.1,177,66,111,37,4.8,34,10,24,29,2.9,36907,47
10005403-the_baxter,5.1,73,24,49,32,4.8,24,6,18,25,3.7,1793,76
cave,3.5,105,12,93,11,3,24,1,23,4,2.8,10980,38
undiscovered,3.2,66,5,61,7,3.5,24,3,21,12,3.1,1795,53
dirty_deeds,5.7,13,8,5,61,0,3,1,2,33,0,0,0
constant_gardener,7.6,181,151,30,83,8.2,36,33,3,91,3.5,31578,81
62,0,0,0,0,0,0,0,0,0,0,0,0,0
margaret_cho_assassin,4.7,24,9,15,37,5.1,12,6,6,50,3.3,467,61
just_like_heaven,5.7,148,84,64,56,5.2,30,12,18,40,3.6,90795,77
proof,6.4,138,87,51,63,6.4,34,20,14,58,3.2,15629,57
1151780-venom,3.1,62,6,56,9,3.5,19,3,16,15,2.6,2557,30
cry-wolf,4,43,10,33,23,4.6,10,4,6,40,3,9727,57
everything_is_illuminated,6.5,118,79,39,66,6.3,30,17,13,56,3.9,17347,88
thumbsucker,6.7,107,75,32,70,6.8,27,19,8,70,3.3,10573,68
thing_about_my_folk,5.5,64,28,36,43,5,20,8,12,40,2.8,3150,40
in_old_chicago,0,3,1,2,33,0,0,0,0,0,0,0,0
my-stupid-neighbor,0,0,0,0,0,0,0,0,0,0,0,0,0
revenge_of_the_ninja,0,0,0,0,0,0,0,0,0,0,0,0,0
1008437-go_west,6.5,9,8,1,88,0,0,0,0,0,0,0,0
1155622-why_we_fight,7,108,86,22,79,7.1,32,24,8,75,3.3,6585,79
gertrud,7.7,9,6,3,66,0,1,0,1,0,3.8,476,77
come-drink-with-me,0,0,0,0,0,0,0,0,0,0,0,0,0
doom,3.9,128,24,104,18,3.8,24,4,20,16,2.7,28789,47
dominos,0,0,0,0,0,0,0,0,0,0,0,0,0
waiting,4.2,87,26,61,29,3.9,25,6,19,24,3.4,35090,76
aeon_flux,3.3,102,10,92,9,3.5,19,2,17,10,2.9,50363,47
unfinished_life,5.9,140,74,66,52,5.4,32,14,18,43,3.3,13634,65
yes_man,5.2,144,62,82,43,4.9,31,12,19,38,3.7,141478,72
1031653-woyzeck,7.3,11,9,2,81,0,2,1,1,50,3.8,1117,79
the-nameless,4.9,6,2,4,33,0,0,0,0,0,0,0,0
flightplan,5.3,169,63,106,37,5.5,35,13,22,37,3.2,35131,56
corpse_bride,7.2,182,152,30,83,7.6,34,31,3,91,3.5,98441,76
green_street_hooligans,5.5,61,28,33,45,5.4,19,9,10,47,3.9,56992,87
history_of_violence,7.9,201,175,26,87,8.4,36,34,2,94,3.4,45849,68
charles-dickens-the-man-who-asked-for-more,0,0,0,0,0,0,0,0,0,0,0,0,0
greatest_game_ever_played,6.2,109,68,41,62,5.7,27,15,12,55,3.6,15763,76
1151898-capote,8.2,179,161,18,89,8.6,39,39,0,100,3.5,35934,72
final_fantasy_7_advent_children,5.7,6,2,4,33,0,0,0,0,0,0,0,0
1155198-cote_dazur,5.6,50,25,25,50,5,16,7,9,43,3.5,393,63
california_roll,0,0,0,0,0,0,0,0,0,0,0,0,0
secret_life_of_daltry_calhoun,3.6,28,2,26,7,3.8,9,0,9,0,2.6,4398,34
into_the_blue,4,123,26,97,21,4.5,31,10,21,32,3.1,24229,67
prize_winner_of_defiance_ohio,6.1,79,46,33,58,6.1,28,14,14,50,3.2,7811,55
mirrormask,5.9,87,47,40,54,5.6,26,11,15,42,3.6,20173,77
1185734-innocence,6.7,17,11,6,64,6.9,8,6,2,75,3.7,1170,73
indiana_jones_and_the_kingdom_of_the_crystal_skull,6.9,246,190,56,77,6.1,41,25,16,60,3.4,252104,59
francesco_giullare_di_dio,8.4,14,14,0,100,0,2,2,0,100,3.9,443,84
wallace_and_gromit_curse_of_the_wererabbit,8.1,172,163,9,94,7.8,35,33,2,94,3.4,30852,72
kiss_kiss_bang_bang,7.4,146,122,24,83,7,35,28,7,80,3.7,46555,83
a-bittersweet-life-dalkomhan-insaeng,8.1,8,8,0,100,0,0,0,0,0,0,0,0
1159353-darwins_nightmare,7.6,51,47,4,92,7.5,20,18,2,90,3.9,1596,83
beowulf_and_grendel,5.4,33,16,17,48,5.2,13,5,8,38,2.9,7530,43
1148076-no_direction_home_bob_dylan,8,14,13,1,92,0,3,3,0,100,4.3,3390,94
1158528-goal,5.2,80,35,45,43,5.2,23,10,13,43,3.7,33414,77
factotum,6.8,111,84,27,75,6.5,29,17,12,58,3.2,9868,51
dont_come_knocking,5.4,100,42,58,42,5.4,27,11,16,40,3,13487,40
in_her_shoes,6.9,162,121,41,74,6.4,38,23,15,60,3.2,31531,65
mother_of_mine-2005,0,3,3,0,100,0,1,1,0,100,4,941,85
squid_and_the_whale,7.9,138,129,9,93,8.2,35,35,0,100,3.6,28511,76
two_for_the_money,4.7,109,23,86,21,5.3,29,5,24,17,3.1,9296,52
separate_lies,6.8,88,63,25,71,7.1,29,22,7,75,3.2,726,46
star-wreck-in-the-pirkinning,0,0,0,0,0,0,0,0,0,0,0,0,0
brokeback_mountain,8.2,233,202,31,86,8.1,42,38,4,90,3.4,82054,77
elizabethtown,4.6,168,46,122,27,4.1,36,7,29,19,3.1,42584,65
north_country,6.7,166,114,52,68,6.8,38,26,12,68,3.5,14739,72
1152019-good_night_and_good_luck,8.1,213,200,13,93,8.2,41,39,2,95,3.6,37838,73
dreamer,6.3,115,73,42,63,6.1,29,17,12,58,3.6,21404,74
1054081-detective_story,6.1,9,6,3,66,0,0,0,0,0,0,0,0
proposition,7.3,123,107,16,86,7.4,31,27,4,87,3.6,20228,77
gospel,4.9,37,12,25,32,5.1,13,5,8,38,3.5,1967,78
dandelion,6.2,12,8,4,66,0,4,2,2,50,3.7,657,75
csa_confederate_states_of_america,7,65,51,14,78,7,20,16,4,80,3.2,1917,50
fog,2.7,66,3,63,4,2.8,11,0,11,0,2.5,14642,35
loggerheads,6.5,46,33,13,71,6.4,18,13,5,72,2.8,4784,36
left_behind_world_at_war,0,2,0,2,0,0,0,0,0,0,0,0,0
protocols_of_zion,6.4,56,39,17,69,5.8,19,11,8,57,2.9,4921,40
same-sex-america,0,0,0,0,0,0,0,0,0,0,0,0,0
atom,0,0,0,0,0,0,0,0,0,0,0,0,0
national_lampoons_barely_legal,0,2,0,2,0,0,1,0,1,0,2.9,2657,39
emmanuels_gift,6.4,22,18,4,81,5.6,8,6,2,75,3.6,352,76
stay,4.6,119,31,88,26,4.2,33,5,28,15,3.4,20956,68
i_confess,7.2,20,17,3,85,0,3,2,1,66,3.6,2474,70
legend_of_zorro,4.8,133,34,99,25,4.8,30,8,22,26,3.2,32197,61
new_york_doll,7.3,51,46,5,90,7.1,14,13,1,92,3.9,843,84
weather_man,6.1,131,76,55,58,6,33,17,16,51,2.9,22086,51
saw_ii,4.6,116,41,75,35,3.9,27,6,21,22,3.2,183455,66
prime,5.6,116,57,59,49,5.7,31,15,16,48,3.1,17427,52
one_wonderful_sunday,6.8,7,6,1,85,0,3,3,0,100,3.7,268,75
teorema,7.4,14,12,2,85,0,4,4,0,100,4,1151,80
1157387-little_fish,6.6,21,18,3,85,6.2,6,5,1,83,2.8,6910,47
american_pie_presents_band_camp,3.7,5,1,4,20,0,0,0,0,0,0,0,0
manderlay,5.6,97,49,48,50,4.3,26,8,18,30,3.6,3901,77
1151916-1151916-nine_lives,6.7,84,63,21,75,7.3,23,19,4,82,3.1,4724,54
dont_be_a_menace,4.5,24,7,17,29,5.6,7,3,4,42,0,0,0
duck_season_2006,7.1,73,66,7,90,7.6,22,20,2,90,0,0,0
revolver2005,3.5,61,10,51,16,3.1,19,1,18,5,3.3,15328,60
1152567-jarhead,6.3,195,119,76,61,6,40,21,19,52,3.3,52128,68
ushpizin,7.4,61,57,4,93,7.7,21,21,0,100,4,763,86
chicken_little,5.4,156,56,100,35,5.5,34,8,26,23,3.2,54371,56
dead_mans_shoes,5.7,40,23,17,57,4.5,11,4,7,36,3.9,22081,83
joyeux_noel,6.8,91,69,22,75,7.1,26,22,4,84,3.6,9688,80
match_factory_girl,0,3,3,0,100,0,0,0,0,0,0,0,0
zombie_and_the_ghost_train,0,3,3,0,100,0,0,0,0,0,0,0,0
get_rich_or_die_tryin,4.4,118,20,98,16,5,27,6,21,22,3.3,42176,73
just_friends,5.1,96,40,56,41,5,27,10,17,37,3.4,46041,73
syriana,6.9,193,139,54,72,7.5,43,37,6,86,3.3,38319,65
calamari-union,0,0,0,0,0,0,0,0,0,0,0,0,0
derailed,4.6,125,25,100,20,4.6,34,6,28,17,3.1,25982,61
1153077-1153077-pride_and_prejudice,7.7,164,140,24,85,7.6,37,32,5,86,3.8,101164,88
wolf_creek,5.5,108,57,51,52,5.2,27,14,13,51,3,24198,50
descent,7.3,165,139,26,84,7,30,22,8,73,3.3,49487,71
takeshis,5.4,5,2,3,40,0,0,0,0,0,0,0,0
harry_potter_and_the_goblet_of_fire,7.4,216,190,26,87,7.2,36,32,4,88,3.4,275215,74
dinner_with_friends,6.4,7,6,1,85,0,0,0,0,0,0,0,0
walk_the_line,7.3,202,166,36,82,7.1,40,30,10,75,3.9,112102,86
1152276-rent,5.8,168,79,89,47,5.5,34,13,21,38,3.5,58040,83
fist-in-his-pocket,0,4,4,0,100,0,0,0,0,0,0,0,0
zathura,6.5,157,118,39,75,6.6,30,22,8,73,3,23630,54
movie_crazy,0,1,0,1,0,0,0,0,0,0,0,0,0
lonesome_jim,6,89,53,36,59,5.7,24,10,14,41,2.9,12480,41
sarah_silverman_jesus_is_magic,6.1,98,63,35,64,6.2,27,18,9,66,3.2,9920,55
bee_season,5.4,104,44,60,42,4.9,32,11,21,34,2.8,3415,37
1153341-breakfast_on_pluto,6.1,114,64,50,56,5.8,28,13,15,46,3.3,14498,73
harvest_2005,0,0,0,0,0,0,0,0,0,0,0,0,0
yours_mine_and_ours,3.3,105,6,99,5,3.7,28,1,27,3,3.2,36270,64
in_the_mix,3.2,37,5,32,13,3.3,14,1,13,7,2.9,13084,48
libertine,4.6,116,35,81,30,4.6,30,7,23,23,3.2,22316,57
first_descent,5.7,61,33,28,54,5.3,21,10,11,47,3,5006,54
wild_geese,6.8,5,3,2,60,0,0,0,0,0,0,0,0
hondo,7.1,5,4,1,80,0,0,0,0,0,0,0,0
bird_with_the_crystal_plumage,7.5,21,19,2,90,0,3,2,1,66,3.7,1755,79
good_woman,5.3,81,30,51,37,5.6,25,8,17,32,2.7,9179,44
taxi_driver,8.7,50,49,1,98,7.7,9,8,1,88,4.1,58145,93
match_point,7.2,205,158,47,77,7.9,40,36,4,90,3.4,41276,78
nazarin,7.8,10,8,2,80,0,2,0,2,0,4.1,418,87
inside_deep_throat,7,120,99,21,82,6.6,40,27,13,67,3.4,1737,61
dying_gaul,5.8,67,33,34,49,5.7,23,10,13,43,3.1,778,55
paradise_now,7.5,99,88,11,88,7.4,30,26,4,86,3.8,9101,81
kid_and_i,4.4,27,9,18,33,4.8,12,4,8,33,2.7,2087,40
chronicles_of_narnia_lion_witch_wardrobe,6.9,206,156,50,75,7.1,38,29,9,76,3.1,260071,62
king_kong,7.7,242,202,40,83,7.6,39,30,9,76,2.8,207337,52
memoirs_of_a_geisha,5.4,158,56,102,35,5.4,36,11,25,30,3.7,71263,82
family_stone,5.9,151,79,72,52,6.1,35,21,14,60,3.2,49319,63
1154356-promise,5.2,77,24,53,31,5.2,26,11,15,42,2.9,11585,41
1060720-kiss_of_death,6.4,36,24,12,66,7.2,12,9,3,75,2.9,2125,39
havoc,5.2,10,4,6,40,0,0,0,0,0,0,0,0
samurai_rebellion,7.4,7,7,0,100,0,2,2,0,100,4.1,907,91
1112470-eisenstein,6.2,11,7,4,63,6.2,5,4,1,80,2.4,42,33
matador,7.2,16,15,1,93,7.3,5,4,1,80,3.7,5436,75
1161542-look_both_ways,6.6,56,43,13,76,6.8,20,16,4,80,3.5,2027,69
mozart_and_the_whale,0,3,2,1,66,0,2,2,0,100,3.8,3940,77
they_died_with_their_boots_on,6.5,10,8,2,80,0,0,0,0,0,0,0,0
three_burials_of_melquiades_estrada,7.4,136,115,21,84,7.5,33,26,7,78,3.7,7818,80
munich,7.5,197,153,44,77,6.8,38,23,15,60,3.6,47552,78
producers_the_movie_musical,5.8,150,76,74,50,5,36,10,26,27,3.1,31343,63
transamerica,6.8,134,102,32,76,6.8,35,27,8,77,3.6,21396,77
rumor_has_it,4.4,110,22,88,20,4.2,30,4,26,13,3,41917,51
cheaper_by_the_dozen_2,3.6,91,6,85,6,3.9,27,3,24,11,3.2,93712,64
fun_with_dick_and_jane,4.9,131,38,93,29,5.2,30,9,21,30,3.2,80127,58
ring,6.6,169,120,49,71,6.3,32,18,14,56,3,146246,50
1156246-casanova,5.6,130,56,74,43,6,37,18,19,48,3.1,29998,57
mrs_henderson_presents,6.6,136,90,46,66,6.7,36,26,10,72,3.3,11358,64
white_countess,6,87,44,43,50,6,27,15,12,55,2.9,8910,39
dirty_love,2.2,28,1,27,3,1.6,10,0,10,0,3.4,3700,67
spirit_of_the_beehive,8.9,18,18,0,100,8.8,7,7,0,100,0,0,0
keeping_mum,5.9,85,48,37,56,5.9,25,15,10,60,3.6,6183,74
goodnight_mister_tom,0,0,0,0,0,0,0,0,0,0,0,0,0
late_spring,8.8,17,17,0,100,0,3,3,0,100,4.3,1093,92
1152954-new_world,6.6,169,102,67,60,6.7,40,22,18,55,2.9,27173,51
seven_faces_of_dr_lao,7.2,5,5,0,100,0,0,0,0,0,0,0,0
boys_of_baraka,6.8,42,31,11,73,6.8,13,10,3,76,4,627,84
1153496-lady_vengeance,7,84,62,22,73,7.3,22,18,4,81,4,23638,86
49th_parallel,7.1,8,7,1,87,0,0,0,0,0,0,0,0
district_b13,7,108,87,21,80,6.7,29,23,6,79,3.6,25880,72
bloodrayne,2.3,49,2,47,4,2.3,13,1,12,7,2.5,34745,31
hostel,5.8,100,59,41,59,5.6,16,6,10,37,3.1,72216,59
grandmas_boy,3.7,60,11,49,18,2.8,16,1,15,6,3.8,55076,85
10004209-tristan_and_isolde,4.9,121,39,82,32,5.3,30,13,17,43,3.4,53037,73
the-road2006,0,0,0,0,0,0,0,0,0,0,0,0,0
10004662-last_holiday,5.8,114,62,52,54,6.1,27,16,11,59,3.3,31706,70
1155109-hoodwinked,5.5,122,58,64,47,4.8,28,10,18,35,3.1,60552,58
aprils-shower,3.6,14,3,11,21,4.2,9,3,6,33,2.6,750,37
underworld_evolution,3.7,100,15,85,15,3.5,16,1,15,6,3.6,111035,77
looking_for_comedy_in_the_muslim_world,5.4,108,46,62,42,5.4,30,11,19,36,2.5,4171,26
shadows-of-forgotten-ancestors,8,16,16,0,100,8.8,5,5,0,100,4.4,312,91
culdesac,7.5,14,12,2,85,0,4,2,2,50,3.8,1039,78
dunwich_horror,4.4,5,1,4,20,0,0,0,0,0,0,0,0
water,7.6,89,81,8,91,7.8,30,28,2,93,3.9,14962,81
sophie_scholl_die_letzten_tage,7.3,94,82,12,87,7.2,25,23,2,92,3.8,7998,83
matti,0,2,2,0,100,0,1,1,0,100,2.7,533,27
worlds_fastest_indian,6.9,136,111,25,81,6.3,29,20,9,68,3.8,6841,88
bandidas,5.4,13,8,5,61,0,2,1,1,50,3,8063,47
tristram_shandy_a_cock_and_bull_story,7.6,120,109,11,90,7.9,32,30,2,93,3.3,8622,60
annapolis,3.9,110,11,99,10,4.1,29,1,28,3,3.2,13763,64
1154157-big_mommas_house_2,3.1,70,4,66,5,3.4,17,2,15,11,3.4,86119,69
1153987-nanny_mcphee,6.6,130,95,35,73,6.4,29,19,10,65,3.2,48480,63
final_destination_3,5.1,114,51,63,44,5,25,8,17,32,3.4,76527,69
something_new,6.1,105,64,41,60,6.8,26,21,5,80,3.1,15411,65
da_block_party,0,0,0,0,0,0,0,0,0,0,0,0,0
madame_curie,6.3,6,5,1,83,0,0,0,0,0,0,0,0
imagine_me_and_you,4.9,94,30,64,31,4.7,23,5,18,21,3.4,21511,68
pink_panther,4.1,139,31,108,22,4.1,32,6,26,18,3,52976,59
10005666-business,5.8,6,3,3,50,0,0,0,0,0,0,0,0
1153951-curious_george,6.1,103,71,32,68,6.1,27,19,8,70,3.2,24897,65
firewall,4.6,153,29,124,18,4.8,38,6,32,15,3,32315,48
tony_takitani,7.4,52,46,6,88,8.1,17,17,0,100,3.9,1083,80
when_a_stranger_calls,3.2,88,8,80,9,3.1,14,1,13,7,3.1,53427,55
tamara,4.3,28,9,19,32,4.7,8,2,6,25,2.7,7152,43
1157247-london,3.3,36,5,31,13,2.7,14,0,14,0,2.9,7900,57
heart_of_gold,8,97,87,10,89,7.9,32,28,4,87,2.9,12241,51
freedomland,4.6,148,34,114,22,4.7,36,13,23,36,2.7,15783,31
winter_passing,5.4,52,21,31,40,5.2,18,7,11,38,2.9,7599,57
eight_below,6.5,139,99,40,71,6.1,31,16,15,51,3.4,27593,80
1155470-date_movie,2.4,83,5,78,6,2.7,15,2,13,13,2.8,89201,51
10004288-running_scared,4.5,128,51,77,39,4.4,31,10,21,32,3.6,35992,77
madeas_family_reunion,4.5,53,14,39,26,4.9,17,7,10,41,3.7,23761,85
1156283-doogal,3.1,49,4,45,8,2.6,15,0,15,0,2.5,8367,27
10004504-ultraviolet,2.8,76,7,69,9,2.1,17,0,17,0,2.6,46298,42
just_my_luck,3.7,108,14,94,12,3.9,30,4,26,13,3,85958,60
pulse,3.5,66,7,59,10,3.1,19,1,18,5,2.7,30788,38
deep_sea_3d,7.7,32,29,3,90,7,12,10,2,83,3.8,3812,75
16_blocks,5.9,157,87,70,55,5.8,35,18,17,51,3.2,31478,60
half-light,4.1,7,2,5,28,0,0,0,0,0,0,0,0
failure_to_launch,4.6,147,37,110,25,5.2,33,13,20,39,3.2,86609,60
ice_age_2,6.1,142,82,60,57,6.2,27,16,11,59,3.6,162267,76
1161913-big_white,4,10,3,7,30,0,2,0,2,0,3.3,2197,56
stromboli,6.5,5,4,1,80,0,0,0,0,0,0,0,0
1159177-free_zone,5,46,12,34,26,4.8,14,2,12,14,2.7,10638,26
naked_spur,8,11,11,0,100,0,1,1,0,100,3.8,668,77
ask_the_dust,5.1,103,37,66,35,5.5,32,16,16,50,2.8,14077,37
v_for_vendetta,6.8,233,169,64,72,6.2,37,23,14,62,3.9,226041,88
im-doing-the-right-thing-with-the-wrong-man,0,0,0,0,0,0,0,0,0,0,0,0,0
thank_you_for_smoking,7.3,177,152,25,85,6.9,38,28,10,73,3.7,55103,84
find_me_guilty,6,104,62,42,59,6.2,32,17,15,53,3.1,19411,51
inside_man,7.3,195,168,27,86,7.5,40,35,5,87,3.7,84980,81
tsotsi,7.4,126,102,24,80,7.8,29,26,3,89,3.8,11397,83
aquamarine,5.5,86,45,41,52,5.6,27,15,12,55,3.1,60073,66
lights_in_the_dusk,6.4,37,25,12,67,5.5,12,6,6,50,3.6,1806,69
hills_have_eyes,5.3,133,65,68,48,5,30,12,18,40,3.1,75042,64
shaggy_dog,4.4,103,28,75,27,4.8,29,10,19,34,2.9,41890,50
son_of_the_pink_panther,2.8,18,3,15,16,0,2,0,2,0,2.5,1039,29
1155609-unknown_white_male,6.5,76,56,20,73,6.7,22,17,5,77,2.7,6598,42
the_lives_of_others,8.2,148,138,10,93,8.3,43,41,2,95,4.4,48886,95
nanook-of-the-north,8.6,21,21,0,100,0,3,3,0,100,3.7,1130,77
alien_resurrection,5.8,64,35,29,54,6.1,17,9,8,52,3,25498,50
take_the_lead,5.4,119,52,67,43,5.2,31,12,19,38,3.5,92007,78
1158179-devil_and_daniel_johnston,7.5,105,93,12,88,7.9,28,26,2,92,3.7,11571,74
largent,8.3,16,15,1,93,0,1,1,0,100,4,719,83
mouchette-1967,7.3,11,9,2,81,0,3,2,1,66,4.2,975,89
the-bruce-movie,0,0,0,0,0,0,0,0,0,0,0,0,0
volver,7.8,160,147,13,91,7.9,41,39,2,95,4,29813,88
akeelah_and_the_bee,7,132,110,22,83,7,28,23,5,82,3.6,27397,74
larry_the_cable_guy_health_inspector,2.4,37,2,35,5,2.2,13,0,13,0,3.1,8141,66
10006370-stay_alive,3,57,5,52,8,2.8,14,1,13,7,3.3,40388,60
basic_instinct_2,3.1,149,10,139,6,3.2,35,1,34,2,2.5,28208,33
brick,7.1,134,106,28,79,7.1,31,25,6,80,3.9,44891,82
1184415-evil_aliens,5.6,10,6,4,60,0,0,0,0,0,0,0,0
this_film_is_not_yet_rated,7.2,115,96,19,83,7,35,28,7,80,3.7,11879,74
atl,5.9,86,54,32,62,5.7,29,17,12,58,4,55291,81
slither,6.9,129,110,19,85,6.4,29,22,7,75,3.2,31835,58
benchwarmers,3.1,69,8,61,11,3.2,11,2,9,18,3.4,92722,71
phat_girlz,3.8,43,10,33,23,4.1,13,4,9,30,3.2,19754,64
renaissance,5.4,68,29,39,42,5.7,17,7,10,41,3.3,10097,58
we-r-friends,0,0,0,0,0,0,0,0,0,0,0,0,0
10004941-reefer_madness,6.4,5,3,2,60,0,0,0,0,0,0,0,0
magic,6.8,18,15,3,83,0,2,1,1,50,3.2,1627,56
candy,5.8,74,36,38,48,6.1,24,14,10,58,3.8,9542,78
enfant,7.5,104,89,15,85,7.7,29,25,4,86,3.2,15237,54
hoot,4.7,95,25,70,26,4.8,28,8,20,28,3.2,22689,58
scary_movie_4,4.7,125,46,79,36,5.1,23,10,13,43,3.1,149474,65
hard_candy,6.4,133,91,42,68,6.3,33,22,11,66,3.7,41391,76
1140781-dead_birds,5.9,7,4,3,57,0,0,0,0,0,0,0,0
prairie_home_companion,7.1,188,153,35,81,6.7,39,28,11,71,3,24547,49
sentinel,5,134,44,90,32,5.1,32,11,21,34,3.1,26716,47
wild,4.5,111,21,90,18,4.8,30,8,22,26,3.1,59950,53
silent_hill,4.5,89,26,63,29,3,16,0,16,0,3.2,81448,65
kinky_boots,5.7,106,60,46,56,5.7,32,16,16,50,3.3,19339,63
protector,5.6,90,50,40,55,5.4,23,11,12,47,3.6,21374,75
mission_impossible_3,6.6,217,152,65,70,6.2,42,26,16,61,3.3,86328,69
1156340-rv,4.2,119,28,91,23,4,31,6,25,19,3,55493,59
united_93,8.2,200,181,19,90,7.8,40,35,5,87,3.6,39922,76
stick_it,4.9,96,30,66,31,5,25,9,16,36,3.5,82123,76
footlight_parade,8.4,8,8,0,100,0,0,0,0,0,0,0,0
american_haunting,3.5,68,8,60,11,3.5,15,2,13,13,3,32251,48
down_in_the_valley,6,101,52,49,51,5.6,31,13,18,41,3,15861,47
hidden_blade,7.2,31,27,4,87,7.4,7,7,0,100,3.1,10744,50
over_the_hedge,6.8,163,121,42,74,6.3,34,22,12,64,3.6,155694,73
art_school_confidential,5.4,133,47,86,35,5.4,33,14,19,42,3,9231,48
poseidon,4.9,196,65,131,33,4.8,39,11,28,28,3,65499,57
da_vinci_code,4.8,219,54,165,24,4.1,42,4,38,9,3.2,124708,64
x_men_3_the_last_stand,5.9,227,129,98,56,5.6,42,22,20,52,3.6,198041,73
break_up,5,187,62,125,33,4.5,40,8,32,20,3.1,107481,52
peaceful_warrior,4.7,72,17,55,23,4.2,23,3,20,13,3.5,16870,66
cars,6.9,192,142,50,73,6.7,40,29,11,72,3.7,182909,80
10002516-lost_city,4.6,84,21,63,25,4.5,30,7,23,23,3.2,13324,50
vera_cruz,6.4,9,7,2,77,0,0,0,0,0,0,0,0
notorious_betty_page,6,132,74,58,56,5.9,40,22,18,55,3.1,14609,46
1156415-on_a_clear_day,6.2,65,43,22,66,6.1,22,12,10,54,3.4,4873,60
1015517-omen,7,32,27,5,84,0,2,1,1,50,3.5,17016,78
the-king,6,77,43,34,55,6,25,13,12,52,3,14647,49
nacho_libre,5.1,162,64,98,39,5,35,12,23,34,2.9,76491,57
lake_house,5,154,55,99,35,4.9,40,11,29,27,3.5,118884,75
click,4.8,165,53,112,32,4.8,36,11,25,30,3.4,221348,72
seventh_victim,7.4,11,10,1,90,0,2,1,1,50,3.6,499,68
the_devil_wears_prada,6.6,183,138,45,75,6.9,42,35,7,83,3.6,163192,76
pirates_of_the_caribbean_dead_mans_chest,6,217,117,100,53,5.2,39,16,23,41,3.9,395865,86
you_me_and_dupree,4.3,164,34,130,20,4.2,36,4,32,11,3.2,90944,59
clerks_2,6.1,158,99,59,62,5.8,35,19,16,54,3.7,70058,83
lady_in_the_water,4.2,207,50,157,24,3.8,38,5,33,13,3,72266,54
my_super_ex_girlfriend,5.1,126,50,76,39,5.3,31,14,17,45,2.7,73211,43
1158185-see_no_evil,2.6,57,5,52,8,2.5,14,1,13,7,3.3,46137,61
1158195-marie_antoinette,6,175,96,79,54,6,40,20,20,50,3,59278,56
who_killed_the_electric_car,7.2,103,91,12,88,7.1,30,28,2,93,3.6,16624,73
inconvenient_truth,7.7,158,147,11,93,7.7,34,32,2,94,3.6,41842,75
hollow_man_ii,0,4,0,4,0,0,0,0,0,0,0,0,0
mountain-patrol-kekexili,7.6,49,48,1,97,7.6,19,18,1,94,4,844,88
high_school_musical,5.4,8,5,3,62,0,0,0,0,0,0,0,0
1156352-adam_and_steve,5.5,38,21,17,55,5.3,17,9,8,52,2.9,13053,39
stoned,4.1,47,7,40,14,3.7,17,1,16,5,3,12252,44
marked_woman,0,4,4,0,100,0,0,0,0,0,0,0,0
fearless-a-chinese-hero,0,0,0,0,0,0,0,0,0,0,0,0,0
fast_and_the_furious_tokyo_drift,4.7,107,38,69,35,5.1,30,13,17,43,3.6,152700,80
garfield_2,3.5,73,8,65,10,4.4,22,6,16,27,3.2,42950,60
metal_a_headbangers_journey,6.9,29,26,3,89,6.6,10,9,1,90,4.1,3059,89
waist_deep,4.3,77,21,56,27,4.7,24,9,15,37,3.6,25532,74
superman_returns,7.1,254,193,61,75,6.8,43,31,12,72,3.3,112381,67
road_to_guantanamo,7.1,94,81,13,86,7,30,25,5,83,3.4,13498,63
edmond,5.6,72,33,39,45,5.5,17,8,9,47,2.8,11822,37
1159100-oh_in_ohio,4.6,69,15,54,21,4.6,24,6,18,25,2.9,10204,36
little_miss_sunshine,7.7,205,186,19,90,7.4,44,39,5,88,4,163418,90
brothers_of_the_head,6.4,65,43,22,66,5.9,18,10,8,55,3,11333,42
300_spartans,0,3,1,2,33,0,0,0,0,0,0,0,0
fallen_idol,8.6,26,26,0,100,8.5,12,12,0,100,4,609,88
babel,6.7,192,132,60,68,6.6,42,27,15,64,3.5,86426,76
1152191-strangers_with_candy,5.8,98,51,47,52,5.3,30,12,18,40,2.9,24171,49
zui-hao-de-shi-guang-three-times,7.8,50,43,7,86,7.8,21,18,3,85,3.6,1630,69
wordplay,7.4,120,114,6,95,7.3,36,35,1,97,3.2,12179,56
army-of-shadows-1969,8.6,72,70,2,97,8.4,22,21,1,95,4.4,2190,94
little_man,3.2,89,11,78,12,3.9,24,6,18,25,3.1,78948,68
purple_plain,0,1,1,0,100,0,0,0,0,0,0,0,0
end_of_the_spear,5.1,51,20,31,39,4.3,17,3,14,17,3.7,2835,82
monster_house,6.8,156,115,41,73,6.2,35,24,11,68,3.2,42058,63
colour-me-kubrick,5.6,58,30,28,51,5.5,22,9,13,40,3.1,3512,43
snakes_on_a_plane,6.2,169,116,53,68,5.9,36,21,15,58,2.9,72394,55
scoop,5.4,137,53,84,38,5.4,36,12,24,33,3.2,28506,56
talladega_nights_the_ballad_of_ricky_bobby,6.5,182,131,51,71,6.7,39,27,12,69,3.4,130490,73
night_at_the_museum,5.3,129,56,73,43,5.3,29,12,17,41,3.6,169931,76
world_trade_center,6.7,223,153,70,68,7,43,32,11,74,3.4,67835,67
stranger_than_fiction,6.8,167,121,46,72,6.8,38,27,11,71,3.6,92551,82
miami_vice,5.6,189,89,100,47,6.4,41,28,13,68,2.8,55637,48
shadowboxer,4,57,11,46,19,3.6,21,2,19,9,2.9,11651,40
pursuit_of_happyness,6.4,166,110,56,66,6.1,38,25,13,65,4.1,211913,88
tears_of_the_black_tiger,6.6,61,46,15,75,7,18,15,3,83,3.7,894,73
john_tucker_must_die,4.3,92,23,69,25,4.2,26,4,22,15,3.6,194452,74
ant_bully,6.2,113,71,42,62,6.2,30,18,12,60,3.1,34181,51
mrs_palfrey_at_the_claremont,6.4,55,38,17,69,7,20,15,5,75,3.8,1500,77
crank,6,87,53,34,60,5,14,4,10,28,3.5,85861,72
secret_life_of_words,6.3,38,27,11,71,5.9,14,10,4,71,4.1,2452,87
10006150-chaos,0,4,1,3,25,0,0,0,0,0,0,0,0
the_night_listener,5.4,133,53,80,39,5.2,29,9,20,31,2.9,28560,36
barnyard_the_original_party_animals,4.4,92,21,71,22,5.1,26,9,17,34,3.3,56716,61
murmur_of_the_heart,8.3,9,8,1,88,0,1,1,0,100,4,1029,86
canterbury_tales,6.8,7,5,2,71,0,1,0,1,0,3.5,627,63
dirty_mary_crazy_larry,4.4,12,5,7,41,0,2,0,2,0,3.4,1249,66
step_up,4.5,99,19,80,19,4.5,27,6,21,22,3.9,236004,85
zoom,3,58,2,56,3,2.7,15,0,15,0,3,23825,51
10007333-bon_cop_bad_cop,6.1,6,4,2,66,0,2,2,0,100,3.8,4674,82
half_nelson,7.6,151,136,15,90,7.9,35,33,2,94,3.8,16884,82
moustache,7.3,41,35,6,85,7.4,18,16,2,88,3.4,1156,62
tideland,4,73,21,52,28,2.8,21,1,20,4,3.3,15608,62
cabin_in_the_sky,6.9,10,8,2,80,0,0,0,0,0,0,0,0
material_girls,2.5,50,2,48,4,2.2,13,1,12,7,3,80733,57
accepted,5,109,40,69,36,4.7,28,7,21,25,3.5,88251,75
illusionist,6.9,178,131,47,73,7.3,37,32,5,86,3.8,105389,83
adventures_of_don_juan,0,1,1,0,100,0,0,0,0,0,0,0,0
queen,8.4,180,174,6,96,8.6,40,40,0,100,3.5,39506,74
thirty_six_quai_des_orfevres,7.5,5,5,0,100,0,0,0,0,0,0,0,0
beerfest,5,104,41,63,39,4.4,26,7,19,26,3.4,42736,76
how_to_eat_fried_worms,6,71,41,30,57,5.8,25,13,12,52,3,15503,51
invincible,6.4,132,94,38,71,6.2,32,19,13,59,3.6,34698,75
idlewild,5.7,125,59,66,47,5.7,35,15,20,42,3.3,11257,63
red_balloon,8.4,15,15,0,100,0,2,2,0,100,4.2,2073,90
way_out_west,8.5,7,7,0,100,0,0,0,0,0,0,0,0
angela-2007,5.5,86,38,48,44,5.1,28,8,20,28,3.4,17241,73
green_for_danger,7.6,10,8,2,80,0,2,1,1,50,3.8,410,81
quinceanera,7.1,94,81,13,86,6.9,30,25,5,83,3.2,9983,53
enjoying-wine-with-mark-phillips2006,0,0,0,0,0,0,0,0,0,0,0,0,0
1053155-lassie,6.8,8,6,2,75,0,2,2,0,100,2.9,2577,52
1023637-wicker_man,7.7,45,41,4,91,0,4,4,0,100,3.6,8988,79
crossover,3.2,63,2,61,3,3.1,22,0,22,0,3.3,23508,61
the_quiet,4,93,20,73,21,3.5,26,3,23,11,3.1,10194,51
sketches_of_frank_gehry,6.9,78,63,15,80,6.9,26,19,7,73,2.9,10414,41
wind_that_shakes_the_barley,7.6,111,98,13,88,7.3,26,23,3,88,4,12108,86
1153570-fateless,7.9,63,58,5,92,8.3,20,19,1,95,3.4,5242,63
severance,6,85,55,30,64,6.1,28,18,10,64,3.3,30894,62
time_to_leave,6.6,50,38,12,76,6.6,16,12,4,75,3.4,8681,62
hollywoodland,6.5,178,122,56,68,6.5,37,23,14,62,3,27144,47
covenant,2.7,71,2,69,2,2.8,18,0,18,0,3.3,56344,68
assassination_of_jesse_james_by_the_coward_robert_ford,7.1,162,121,41,74,6.6,36,22,14,61,3.7,57534,73
last_kiss,5.7,124,57,67,45,6,31,15,16,48,3.2,37077,59
trust_the_man,4.6,100,27,73,27,4.5,25,3,22,12,2.9,11451,38
fly-words-remembered,0,0,0,0,0,0,0,0,0,0,0,0,0
idiocracy,6.5,40,29,11,72,5.4,5,3,2,60,3.2,21918,57
jesus_camp,7.2,97,84,13,86,7.2,24,21,3,87,3.6,17583,76
tiger_and_the_snow,3.6,23,4,19,17,3.1,8,2,6,25,4.1,3393,84
snoopy-come-home,7.6,9,8,1,88,0,2,1,1,50,3.7,738,80
the_science_of_sleep,6.6,153,107,46,69,6.5,34,23,11,67,3.8,53923,81
black_dahlia,4.8,182,60,122,32,4.3,38,4,34,10,2.7,40782,32
wood,6,56,34,22,60,5.7,17,10,7,58,3.9,6421,90
everyones_hero,5.1,66,26,40,39,5.6,25,11,14,44,3.1,15884,51
gridiron_gang,5.6,99,41,58,41,5.2,26,8,18,30,3.7,74026,84
streamers,6.1,9,5,4,55,0,2,0,2,0,3.2,136,49
1153319-land_of_plenty,6.3,25,16,9,64,6,7,4,3,57,3.5,683,63
taxidermia,6.7,46,37,9,80,7.8,7,6,1,85,3.8,2168,78
1169498-bridge,6.4,55,37,18,67,7,15,13,2,86,3.7,3171,74
private_life_of_henry_viii,8,10,10,0,100,0,0,0,0,0,0,0,0
apocalypto,6.3,184,117,67,63,5.8,43,25,18,58,3.7,132213,79
1161034-flyboys,4.9,126,41,85,32,4.1,30,5,25,16,3.4,25191,69
jackass_number_2,5.8,103,65,38,63,5.6,24,14,10,58,3.6,75153,83
conversations_with_other_women,6.5,58,42,16,72,5.7,17,9,8,52,3.7,4754,74
otets-sergiy-father-sergius,0,0,0,0,0,0,0,0,0,0,0,0,0
borat,8,209,191,18,91,8.1,41,40,1,97,3.4,141091,76
pans_labyrinth,8.6,193,184,9,95,8.8,39,39,0,100,4.1,183647,90
guardian,5.2,143,54,89,37,5.2,34,11,23,32,3.7,58919,83
open_season,5.4,98,46,52,46,5.7,24,13,11,54,3.4,91895,66
school_for_scoundrels,4.6,137,35,102,25,4.5,32,8,24,25,3.2,39981,57
departed,8.2,228,211,17,92,8,44,41,3,93,4.1,195210,92
texas_chainsaw_massacre_the_beginning,3.5,79,10,69,12,3.1,14,1,13,7,3.2,72600,64
employee_of_the_month,4,88,18,70,20,3.9,25,4,21,16,3.2,54090,61
stormbreaker,4.7,65,21,44,32,4.7,23,8,15,34,3.3,16210,64
running_with_scissors,5,129,39,90,30,5,38,12,26,31,3.1,39912,55
10009526-public_enemies,6.4,245,166,79,67,5.9,40,24,16,60,3.2,244294,65
ellie_parker,5.6,46,24,22,52,5.6,16,8,8,50,2.9,1159,41
grudge_2,3.4,71,7,64,9,3.4,17,1,16,5,2.8,45131,57
man_of_the_year,4.4,141,30,111,21,5,35,11,24,31,3,29127,51
marine,4,45,9,36,20,4.5,11,3,8,27,3.2,48769,69
infamous,6.8,145,104,41,71,6.7,37,26,11,70,3.3,9766,60
one_night_with_the_king,4.3,25,4,21,16,4.4,9,2,7,22,3.9,8409,81
chapayev,0,0,0,0,0,0,0,0,0,0,0,0,0
feast,5.8,49,27,22,55,4.6,11,5,6,45,3.3,6353,62
offside,8,82,78,4,95,8.2,25,24,1,96,3.6,2373,71
little_children,7.4,154,122,32,79,7.7,40,36,4,90,3.7,34155,79
deliver_us_from_evil,8.4,69,69,0,100,8.2,25,25,0,100,3.7,8806,77
facing_the_giants,4.1,23,2,21,8,3.6,5,0,5,0,3.9,26252,85
last_king_of_scotland,7.3,177,154,23,87,7.4,40,36,4,90,3.8,58962,87
us_vs_john_lennon,6.6,94,72,22,76,6.5,29,20,9,68,3.6,8813,70
shortbus,6.4,119,78,41,65,5.8,37,21,16,56,3.7,15870,75
children_of_men,8,208,193,15,92,7.8,41,37,4,90,3.7,127695,81
prestige,7.1,187,141,46,75,6.2,40,23,17,57,3.9,138467,90
flags_of_our_fathers,7,191,139,52,72,7.5,44,34,10,77,3.5,54914,70
flicka,5.7,76,41,35,53,5.6,24,12,12,50,3.7,22360,82
a_guide_to_recognizing_your_saints,6.6,93,70,23,75,6.3,28,19,9,67,3.3,23093,67
13_tzameti,7,67,56,11,83,6.3,22,16,6,72,3.9,3433,84
saw_3,4.2,83,21,62,25,3.2,18,1,17,5,3.7,159522,79
catch_a_fire,6.7,137,104,33,75,6.5,37,28,9,75,3.4,13062,64
death_of_a_president,5.3,99,36,63,36,4.7,33,7,26,21,3.2,5541,54
beast_with_five_fingers,6.5,9,7,2,77,0,1,1,0,100,0,0,0
butterfly_effect_2,0,1,1,0,100,0,0,0,0,0,0,0,0
flushed_away,6.7,128,92,36,71,6.7,33,25,8,75,3.3,58694,68
perfume_the_story_of_a_murderer,6.2,121,70,51,57,5.6,36,16,20,44,3.4,41387,74
arabesque,6.1,7,5,2,71,0,0,0,0,0,0,0,0
santa_clause_3,3.6,64,9,55,14,4.2,16,3,13,18,3.1,31916,59
mom_and_dad_save_the_world,2.2,9,1,8,11,0,0,0,0,0,0,0,0
good_year,4.8,126,30,96,23,4.8,37,11,26,29,3.3,22634,62
limit-21-realtime,0,0,0,0,0,0,0,0,0,0,0,0,0
foreign_affair,7.6,9,9,0,100,0,2,2,0,100,3.7,504,75
return,3.9,55,8,47,14,3.9,15,2,13,13,2.9,26258,38
1159169-for_your_consideration,5.8,156,78,78,50,6.4,37,23,14,62,3,5643,44
fuck,5.8,71,39,32,54,5.3,21,10,11,47,3.5,3961,68
beyond-the-gates,7.2,60,50,10,83,6.5,18,13,5,72,3.9,11089,81
casino_royale,7.8,214,202,12,94,7.8,43,41,2,95,3.9,155430,87
happy_feet,6.9,158,117,41,74,6.9,36,30,6,83,3.6,194573,75
lets_go_to_prison,2.9,40,4,36,10,3.1,13,1,12,7,3.1,24118,51
new-orleans-exposed-before-and-after-katrina,0,0,0,0,0,0,0,0,0,0,0,0,0
1162559-bobby,5.6,167,77,90,46,5.6,39,18,21,46,3.6,13513,74
deck_the_halls,2.9,81,5,76,6,3.2,24,2,22,8,2.8,16598,45
10_items_or_less,6.1,59,36,23,61,5.7,24,13,11,54,3.3,11471,57
holiday_2006,0,0,0,0,0,0,0,0,0,0,0,0,0
snow_cake,6.1,61,40,21,65,4.9,18,7,11,38,4,6153,85
harsh_times,5.5,98,47,51,47,5.1,29,10,19,34,3.2,27914,56
fast_food_nation,5.7,140,71,69,50,5.5,34,13,21,38,3,26331,43
la-bete-humaine-judas-was-a-womanthe-human-beast,8,12,12,0,100,0,2,2,0,100,4,587,86
tenacious_d_in_the_pick_of_destiny,5.7,119,64,55,53,5.5,34,16,18,47,3.3,63427,69
1197120-oss_117_cairo_nest_of_spies,6.6,56,42,14,75,6.2,14,8,6,57,3.7,2771,74
nativity_story,5.3,126,47,79,37,5.8,35,19,16,54,3.5,18145,74
van_wilder_2,2.7,44,3,41,6,2.9,18,1,17,5,3,24260,48
turistas,3.8,100,16,84,16,4,28,6,22,21,2.8,21560,36
blood_diamond,6.3,209,130,79,62,6.4,43,29,14,67,4,155615,90
draculas_daughter,5.6,11,5,6,45,0,0,0,0,0,0,0,0
unaccompanied_minors,4.5,86,26,60,30,4,26,5,21,19,3.3,18555,62
off_the_black,6.2,40,27,13,67,6.4,17,13,4,76,3.3,1007,57
charlottes_web,7,142,111,31,78,6.9,35,25,10,71,3.3,39179,67
more-than-you2006,0,0,0,0,0,0,0,0,0,0,0,0,0
rocky_balboa,6.5,173,131,42,75,6.4,36,27,9,75,3.5,88339,77
fur,4.9,108,34,74,31,4.3,37,7,30,18,3.5,6462,64
dam_busters,8.6,5,5,0,100,0,0,0,0,0,0,0,0
painted_veil,7.1,143,106,37,74,7.3,35,26,9,74,3.9,20954,85
we_are_marshall,5.8,124,61,63,49,5.1,29,13,16,44,3.6,38195,81
plague_dogs,0,1,1,0,100,0,0,0,0,0,0,0,0
good_shepherd,6.1,167,90,77,53,6.3,38,21,17,55,3.1,51101,52
dreamgirls,7.2,200,156,44,78,7.4,44,38,6,86,3.5,87867,73
page_turner,6.8,63,49,14,77,6.9,19,13,6,68,3.5,2737,67
freedom_writers,6.3,121,84,37,69,6.4,32,22,10,68,3.9,77693,88
inland_empire,7.1,101,73,28,72,6.4,25,13,12,52,3.8,17370,75
history_boys,6.4,104,66,38,63,6.4,35,21,14,60,3.5,10240,70
notes_on_a_scandal,7.5,167,145,22,86,8,36,33,3,91,3.7,22200,81
doa_dead_or_alive,4.5,44,15,29,34,4.2,10,2,8,20,2.7,71044,43
curse_of_the_golden_flower,6.4,120,79,41,65,6.4,34,20,14,58,3.5,17358,67
bothersome_man,6.6,21,15,6,71,7,6,5,1,83,3.9,2273,83
good_german,5,146,47,99,32,5,40,12,28,30,2.9,14972,35
sweet_land,7.3,70,59,11,84,7.5,23,20,3,86,3.9,2319,81
letters_from_iwo_jima,8.2,196,178,18,90,8.3,40,37,3,92,3.8,73433,85
black-love,0,0,0,0,0,0,0,0,0,0,0,0,0
happily_never_after,3,80,3,77,3,3.5,23,0,23,0,2.9,50375,44
home_of_the_brave,4.1,56,12,44,21,4.8,17,6,11,35,3.2,13047,51
code_name_the_cleaner,2.9,81,3,78,3,3.5,20,2,18,10,2.8,15990,45
stomp_the_yard,4.5,88,23,65,26,4.7,27,8,19,29,3.8,131307,83
miss_potter,6.2,123,81,42,65,5.8,38,20,18,52,3.2,35425,67
10004659-arthur,4.5,90,19,71,21,4.2,25,4,21,16,3.2,25956,62
american-pie-5-the-naked-mile,0,3,0,3,0,0,0,0,0,0,0,0,0
the-young-girls-of-rochefort,7.9,34,33,1,97,8.6,6,6,0,100,3.9,1140,82
david_and_bathsheba,0,0,0,0,0,0,0,0,0,0,0,0,0
old_joy,7.3,84,71,13,84,7.1,27,23,4,85,3.7,1584,75
venus,7.3,145,129,16,88,8,35,35,0,100,3.6,3984,73
rosario-tijeras,0,0,0,0,0,0,0,0,0,0,0,0,0
little_world_of_don_camillo,0,0,0,0,0,0,0,0,0,0,0,0,0
primeval,3.6,52,10,42,19,3.5,13,2,11,15,2.7,14738,36
alpha_dog,5.5,141,78,63,55,5.6,36,20,16,55,3.3,59805,68
hitcher,3.8,93,19,74,20,3.5,16,2,14,12,3.1,49309,59
dead_mary,0,3,1,2,33,0,0,0,0,0,0,0,0
testament-of-orpheus,7.2,5,4,1,80,0,0,0,0,0,0,0,0
after_the_wedding,7.4,101,88,13,87,7.6,30,27,3,90,3.7,12261,86
linda_linda_linda,6.9,9,7,2,77,0,4,3,1,75,4,833,86
bridge_to_terabithia,7.2,143,122,21,85,7.2,27,23,4,85,3.4,97023,71
blood_of_a_poet,7.3,14,13,1,92,0,1,0,1,0,3.9,760,82
49_up,8.2,61,59,2,96,8.2,24,22,2,91,3.2,6671,57
waitress,7.3,162,144,18,88,7.6,35,34,1,97,3.4,228321,67
catch_and_release,4.5,131,28,103,21,4.5,33,9,24,27,3.2,45131,57
smokin_aces,4.3,153,43,110,28,4,34,6,28,17,3.3,94720,64
blood_and_chocolate,3.6,73,8,65,10,3.3,17,1,16,5,3.1,38058,56
epic_movie,2.3,62,1,61,1,2.6,15,1,14,6,2.5,152790,38
the_messengers,3.7,83,10,73,12,3.6,19,1,18,5,3.1,129304,48
because_i_said_so,3.2,155,8,147,5,3.7,37,4,33,10,3.3,96755,68
hannibal_rising,3.9,141,21,120,14,3.7,30,2,28,6,3.3,109979,61
norbit,3.2,120,10,110,8,3.3,29,1,28,3,3.1,204857,56
1174004-boss_of_it_all,6.5,63,46,17,73,7.1,17,14,3,82,3.6,2971,70
10007598-cocaine_cowboys,6.4,49,34,15,69,6.1,17,10,7,58,3.3,18459,68
lonely_hearts,5.6,42,20,22,47,5.5,14,7,7,50,3.2,4965,52
ratatouille,8.4,213,205,8,96,8.3,42,41,1,97,3.9,414956,84
10002128-lola,8.1,6,6,0,100,0,1,1,0,100,3.9,529,82
paris_je_taime,7,109,93,16,85,7,29,24,5,82,3.8,48639,83
astronaut_farmer,6,134,77,57,57,5.9,31,18,13,58,3,30327,52
myra_breckinridge,4.4,21,6,15,28,0,3,0,3,0,2.8,407,39
10006917-days_of_glory,7.2,85,70,15,82,7.7,28,26,2,92,3.7,5161,77
1020270-1020270-strange_case_of_dr_jekyll_and_mr_hyde,0,0,0,0,0,0,0,0,0,0,0,0,0
unknown,5.1,44,17,27,38,4.6,17,4,13,23,3.3,6616,57
ghost_rider,4.3,130,34,96,26,4.3,21,6,15,28,3.2,233712,56
breach,7,174,145,29,83,6.8,44,33,11,75,3.4,84757,65
daddys_little_girls,4.8,52,14,38,26,5.4,20,8,12,40,3.9,88879,80
music_and_lyrics,6,163,102,61,62,6.4,33,28,5,84,3.4,109147,70
the_number_23,3.5,186,15,171,8,3.6,37,3,34,8,3.2,101409,61
reno_911_miami,5,95,33,62,34,5,24,8,16,33,3,48867,52
black_snake_moan,6.3,152,100,52,65,5.7,39,19,20,48,3.3,48404,70
gray_matters,3.8,64,5,59,7,3.5,21,1,20,4,3.1,5341,47
loudquietloud_a_film_about_the_pixies,6.2,21,14,7,66,5.2,7,2,5,28,3.8,484,77
factory_girl,4.7,112,21,91,18,4.6,36,5,31,13,3.3,24687,60
hot_fuzz,7.7,194,176,18,90,7.2,39,36,3,92,4,177532,88
36th-chamber-of-shaolin-shao-lin-san-shi-liu-fang,0,1,0,1,0,0,0,0,0,0,0,0,0
1168275-karla,3.4,12,0,12,0,0,3,0,3,0,2.9,1042,38
golden_door,6.8,86,62,24,72,6.9,27,18,9,66,3.6,2001,68
cats_the_musical,4.2,5,1,4,20,0,0,0,0,0,0,0,0
next,4.6,128,36,92,28,4.2,21,5,16,23,3.2,60971,59
breaking_and_entering,5.2,124,42,82,33,5.2,37,11,26,29,3.2,28113,52
10007415-amazing_grace,6.6,118,83,35,70,6.6,31,20,11,64,4,24835,85
zodiac,7.6,226,202,24,89,7,48,39,9,81,3.5,90179,73
babylon-5-the-gathering,0,0,0,0,0,0,0,0,0,0,0,0,0
wild_hogs,3.8,139,20,119,14,3.4,34,3,31,8,3.4,86633,72
westerner,0,4,4,0,100,0,0,0,0,0,0,0,0
ultimate_gift,5.1,58,19,39,32,4.6,14,3,11,21,4.1,16774,85
300,6.1,223,133,90,59,5.6,41,19,22,46,4.1,476879,90
abandon,4.3,109,18,91,16,4.1,26,6,20,23,2.7,2670,37
caesar,0,1,0,1,0,0,0,0,0,0,0,0,0
starter_for_ten,6.9,74,66,8,89,6.9,23,19,4,82,3.4,6446,64
mimzy,5.8,122,65,57,53,5.8,28,14,14,50,3.1,37595,58
priceless,6.9,70,57,13,81,6.6,17,13,4,76,3.7,9304,74
host,7.7,144,133,11,92,7.8,37,35,2,94,3.4,41174,69
becoming_jane,6,134,78,56,58,6.2,33,19,14,57,3.7,77694,75
taste_of_honey,7,10,8,2,80,0,3,2,1,66,4,686,86
namesake,7.5,124,106,18,85,7.6,33,28,5,84,3.7,28074,78
i-love-this-movie,0,0,0,0,0,0,0,0,0,0,0,0,0
fugitive_kind,6.4,10,6,4,60,0,0,0,0,0,0,0,0
premonition,3.8,161,13,148,8,4.3,37,6,31,16,3.1,84740,55
dead_silence,3.9,73,15,58,20,4.2,13,4,9,30,3.2,53019,57
reign_over_me,6.3,149,94,55,63,6.6,35,22,13,62,3.8,58189,81
pride,5.5,107,49,58,45,5.5,34,15,19,44,3.6,27617,73
shooter,5.6,142,68,74,47,5.6,39,18,21,46,3.8,120688,82
hills_have_eyes_2,3.2,64,7,57,10,3.6,16,2,14,12,2.9,63799,50
teenage_mutant_ninja_turtles,5,114,38,76,33,4.4,22,4,18,18,3.2,86247,63
italian,7.2,93,85,8,91,7.3,29,27,2,93,3.3,9946,67
jindabyne,6.4,94,61,33,64,5.9,27,14,13,51,3.1,3036,50
avenue_montaigne,6.5,95,71,24,74,7.2,29,27,2,93,3.5,8387,64
10007417-black_book,7.1,147,112,35,76,7,36,28,8,77,4,14532,87
quiet_duel,0,1,1,0,100,0,0,0,0,0,0,0,0
darwin_awards,4.9,12,3,9,25,0,3,0,3,0,3.1,2472,48
lookout,7.3,163,142,21,87,7.2,34,29,5,85,3.5,29621,71
blades_of_glory,6.2,183,127,56,69,6.4,40,27,13,67,3.4,665973,66
are_we_done_yet,3.3,93,7,86,7,3.8,24,4,20,16,3.2,59360,61
grindhouse,7.4,188,155,33,82,7.1,40,31,9,77,3.9,98721,86
reaping,3.5,130,11,119,8,3.8,26,2,24,7,3.2,39427,54
firehouse_dog,4.9,81,31,50,38,5,25,11,14,44,3.4,23925,68
meet_the_robinsons,6.3,135,89,46,65,6.3,31,19,12,61,3.5,80580,75
seraphim_falls,5.7,81,44,37,54,5.2,19,8,11,42,3.3,4135,55
ignite_2007,0,0,0,0,0,0,0,0,0,0,0,0,0
judge_priest,0,3,3,0,100,0,0,0,0,0,0,0,0
copying_beethoven,4.7,79,20,59,25,5.3,21,7,14,33,3.4,850,60
the-hoax2006,0,0,0,0,0,0,0,0,0,0,0,0,0
ulysses-gaze,5.2,15,6,9,40,0,4,2,2,50,4,697,88
how_the_grinch_stole_christmas,5.6,127,67,60,52,5.2,31,16,15,51,3.1,34926,57
goyas_ghosts,4.8,84,24,60,28,4.7,26,8,18,30,3.3,20033,59
1171939-perfect_stranger,3.5,141,15,126,10,3.7,35,4,31,11,3.2,43661,57
disturbia,6.2,168,115,53,68,6,35,23,12,65,3.7,701373,75
pathfinder,3.6,75,8,67,10,3.5,21,1,20,4,2.9,39732,42
aqua_teen_hunger_force_colon_movie_film_for_theatres,5.1,83,39,44,46,5.2,28,14,14,50,3.5,12293,68
puccini_for_beginners,5.6,62,31,31,50,5.7,25,13,12,52,3.2,328,47
yihe-yuan,6.2,28,19,9,67,6.6,10,8,2,80,3.4,653,59
stalags,5.8,12,6,6,50,0,4,1,3,25,3.8,33,80
1177488-contract,4.3,5,0,5,0,0,0,0,0,0,0,0,0
fracture,6.5,163,115,48,70,6.7,39,30,9,76,3.5,129211,71
big_nothing,0,3,3,0,100,0,0,0,0,0,0,0,0
vacancy,5.5,119,66,53,55,5.5,26,15,11,57,3,51558,46
bennys_video,5.3,6,2,4,33,0,0,0,0,0,0,0,0
in_the_land_of_women,5.4,114,50,64,43,5.2,33,15,18,45,3.2,37584,54
mr_beans_holiday,5.4,109,55,54,50,5.6,29,15,14,51,2.9,95541,53
1169203-invisible,4.1,57,12,45,21,4.3,14,3,11,21,3.3,49604,61
a-history-of-dj-krush,0,0,0,0,0,0,0,0,0,0,0,0,0
condemned,3.5,99,15,84,15,3.3,28,3,25,10,3.4,27981,63
spiderman_3,6.2,239,150,89,62,5.4,45,18,27,40,3.3,1192712,54
lucky_you,5,138,40,98,28,4.9,34,8,26,23,2.8,26515,33
21_up,0,1,1,0,100,0,0,0,0,0,0,0,0
year_of_the_dog,6.4,141,98,43,69,7.1,37,30,7,81,2.9,6288,43
fast-track-the-ex,4.4,100,19,81,19,4.2,30,4,26,13,2.8,24933,36
paprika,7.2,86,71,15,82,7.3,27,22,5,81,4,13141,87
red_road,7.3,84,74,10,88,7.7,21,18,3,85,3.6,3304,69
day_watch,5.9,95,60,35,63,6.2,23,18,5,78,3.5,13807,69
this_is_england,7.7,87,81,6,93,7.6,24,22,2,91,4.1,25557,89
away_from_her,8.1,140,132,8,94,8.2,37,37,0,100,3.6,15253,80
what_up,0,1,0,1,0,0,0,0,0,0,0,0,0
hairspray,7.7,205,186,19,90,8,41,40,1,97,3.9,382832,84
28_weeks_later,6.6,182,128,54,70,7,39,30,9,76,3.4,266576,66
georgia_rule,3.8,116,20,96,17,3.4,30,2,28,6,3,64056,55
delta_farce,2.6,44,2,42,4,3.1,12,1,11,8,2.8,23589,45
10004812-red_dust,0,4,4,0,100,0,0,0,0,0,0,0,0
shrek_3,5.5,203,83,120,40,5.7,39,19,20,48,3.4,1369685,57
once,8.3,152,147,5,96,8.4,37,37,0,100,4.1,49591,90
pirates_of_the_caribbean_3,5.4,213,95,118,44,5.2,40,14,26,35,3.8,1768593,74
bug,6.2,128,76,52,59,6.6,36,24,12,66,2.5,168834,31
mr_brooks,5.7,151,84,67,55,5.3,33,16,17,48,3.6,270348,75
fantastic_four_2_rise_of_the_silver_surfer,4.8,165,60,105,36,4.5,34,11,23,32,3.2,470350,55
gracie,5.8,90,53,37,58,5.4,32,16,16,50,3.3,80050,61
im_a_cyborg_but_thats_ok,6.3,7,6,1,85,0,1,1,0,100,3.9,4852,80
eagle_vs_shark,5.6,104,56,48,53,5.4,26,12,14,46,3.5,24010,67
88_minutes,2.6,120,6,114,5,2.7,29,1,28,3,3.2,37899,51
cashback,5.4,49,23,26,46,5.8,17,10,7,58,3.8,24862,79
oceans_thirteen,6.4,195,136,59,69,6,43,25,18,58,3.6,846364,74
ils,6,50,30,20,60,6,12,6,6,50,3.4,4394,62
ten_canoes,7.7,59,58,1,98,7.4,18,18,0,100,3.7,2471,75
sun_alley,0,0,0,0,0,0,0,0,0,0,0,0,0
hostel_2,5.1,106,48,58,45,4.6,21,9,12,42,3,282438,45
paranoid_park,6.9,112,85,27,75,7.1,25,20,5,80,3.5,9375,66
sleepy_hollow,6.3,124,84,40,67,6.2,30,20,10,66,3.5,93949,79
surfs_up,6.6,141,109,32,77,7,31,26,5,83,3.4,372345,64
fantastic_four_2_rise_of_the_silver_surfer,4.8,165,60,105,36,4.5,34,11,23,32,3.2,470350,55
nancy_drew,5.5,134,66,68,49,5.7,36,20,16,55,3.4,111522,62
fido,6.4,69,49,20,71,6.2,16,11,5,68,3.6,27143,70
l-iceberg,6.5,32,22,10,68,6.2,11,8,3,72,3.6,492,70
death_proof,5.8,35,23,12,65,0,2,2,0,100,3.6,52006,73
rescue_dawn,7.5,156,140,16,89,7.7,37,32,5,86,3.5,46938,73
tv_set,6.3,75,48,27,64,6.5,27,19,8,70,3.3,3053,57
valet,6.6,81,56,25,69,6.9,29,22,7,75,3.5,3807,66
night_of_the_generals,0,3,2,1,66,0,0,0,0,0,0,0,0
in_search_of_a_midnight_kiss,7,59,50,9,84,7.1,22,19,3,86,3.8,2278,79
my_voyage_to_italy,8.3,20,20,0,100,0,4,4,0,100,3.9,769,82
power_of_nightmares_the_rise_of_the_politics_of_fear,8.1,7,6,1,85,8,5,4,1,80,4.5,575,96
o_lucky_man,7.6,17,14,3,82,0,2,1,1,50,0,0,0
sicko,7.8,199,185,14,92,7.4,43,38,5,88,3.8,93379,87
mighty_heart,7,188,147,41,78,7.2,44,37,7,84,3.5,55538,70
1408,6.7,165,129,36,78,6.7,32,25,7,78,3.4,349462,61
the-funeral2007,0,0,0,0,0,0,0,0,0,0,0,0,0
live_free_or_die_hard,6.8,197,161,36,81,6.7,38,30,8,78,3.9,1145097,86
1175072-license_to_wed,3.1,122,9,113,7,3.3,26,2,24,7,3.2,197792,55
evening,4.9,124,34,90,27,4.8,31,8,23,25,3.1,49054,49
evan_almighty,4.5,190,44,146,23,4,39,3,36,7,3.2,369422,56
real-the-movie2005,0,0,0,0,0,0,0,0,0,0,0,0,0
captivity,2.7,73,5,68,6,2,15,0,15,0,2.8,42072,32
harry_potter_and_the_order_of_the_phoenix,6.8,234,182,52,77,6.7,41,28,13,68,3.9,1449179,82
i_now_pronounce_you_chuck_and_larry,3.6,154,21,133,13,3.8,34,4,30,11,3.6,920014,73
1167633-driving_lessons,5.2,75,36,39,48,5.3,23,11,12,47,3.2,22883,67
first_snow,5.9,72,41,31,56,6.2,20,12,8,60,3,2700,42
across_the_universe,5.8,151,80,71,52,5.9,30,15,15,50,4,133408,84
broken_english,6.3,73,47,26,64,6.2,23,14,9,60,3.4,14630,61
brand_upon_the_brain,8,47,43,4,91,7.9,17,16,1,94,4,1698,84
hot_rod,4.9,101,40,61,39,4.7,25,7,18,28,3.3,69065,64
stardust,6.8,182,138,44,75,6.7,36,24,12,66,3.9,192854,86
whos_your_caddy,2.3,32,2,30,6,2.9,10,1,9,10,3.4,32708,61
skinwalkers,3.5,36,5,31,13,2.8,11,0,11,0,2.7,28787,33
simpsons_movie,7.5,190,170,20,89,7.3,39,32,7,82,3.7,1305720,78
i_know_who_killed_me,2.1,67,5,62,7,2.1,18,1,17,5,2.5,61978,29
no_reservations,5.2,157,63,94,40,5.2,34,12,22,35,3.4,112453,64
underdog,4,67,10,57,14,4,15,3,12,20,3.1,58055,48
charlie_bartlett,5.8,130,73,57,56,6,29,15,14,51,3.5,29271,73
el_cantante,4.8,103,25,78,24,4.6,29,7,22,24,3.5,4858,64
bourne_ultimatum,7.9,228,213,15,93,8.1,39,38,1,97,4.1,1312487,91
bratz_the_movie,2.9,71,5,66,7,3.2,23,2,21,8,3,27511,51
1175074-my_best_friend,6.6,85,64,21,75,6.6,29,22,7,75,3.5,5539,65
1178913-1178913-you_kill_me,6.6,112,87,25,77,6.8,30,24,6,80,3.3,17284,60
ne_le_dis_a_personne,7.6,103,96,7,93,7.9,25,24,1,96,3.9,11817,86
czech-dream-cesky-sen,6.6,24,19,5,79,6.8,7,6,1,85,3.7,434,74
superbad,7.4,198,173,25,87,7.2,41,35,6,85,4.1,315252,87
arctic_tale,5.8,94,57,37,60,5.4,25,13,12,52,3.5,16362,63
joshua,6.3,97,61,36,62,6.9,31,24,7,77,2.9,13913,40
talk_to_me,6.9,124,101,23,81,7,32,25,7,78,3.6,16542,77
resurrecting_the_champ,6,116,69,47,59,5.5,30,15,15,50,3.4,18572,62
10008005-moliere,6.5,85,60,25,70,6.1,19,11,8,57,3.7,6884,76
rush_hour_3,4.2,155,30,125,19,4.4,29,6,23,20,3.5,270729,68
last_legion,4,54,9,45,16,4,14,1,13,7,2.9,36434,39
10008097-lady_chatterley,6.7,83,62,21,74,7.7,22,19,3,86,3.3,1401,59
balls_of_fury,4.2,127,29,98,22,4.5,24,8,16,33,2.8,85682,36
sydney_white,5,81,30,51,37,4.7,20,5,15,25,3.5,526699,74
the_kingdom,5.8,182,93,89,51,5.5,41,19,22,46,3.6,107436,78
rocket_science,6.9,105,88,17,83,6.9,31,25,6,80,3.6,7963,72
daddy_day_camp,2.3,74,1,73,1,2.4,21,0,21,0,2.9,44524,49
invasion,4.3,156,30,126,19,4.7,34,9,25,26,3,66767,43
the-secret-war,0,0,0,0,0,0,0,0,0,0,0,0,0
mother-nanny,0,0,0,0,0,0,0,0,0,0,0,0,0
september_dawn,3.4,54,7,47,12,2.8,18,0,18,0,3.1,5910,49
1179254-halloween,4.1,101,26,75,25,3.9,19,3,16,15,3.3,79946,64
death_sentence,4.1,110,21,89,19,3.6,28,2,26,7,3.4,42086,62
two_days_in_paris,6.8,113,96,17,84,6.9,34,30,4,88,3.6,27100,71
king_kong,7.7,242,202,40,83,7.6,39,30,9,76,2.8,207337,52
behind_the_mask_the_rise_of_leslie_vernon,6.9,34,25,9,73,6.5,10,7,3,70,3.6,7455,72
brothers_solomon,3.3,72,11,61,15,3.8,20,3,17,15,2.6,21959,31
10008510-bordertown,0,3,2,1,66,0,1,1,0,100,3.4,5023,64
the_nines,6,60,39,21,65,6.2,10,7,3,70,3.4,19000,61
good_night,4.8,41,12,29,29,5,9,3,6,33,2.8,2801,34
planet_terror,6.1,23,17,6,73,0,0,0,0,0,0,0,0
310_to_yuma,7.5,205,182,23,88,7.3,42,36,6,85,3.9,139372,85
shoot_em_up,6.2,156,103,53,66,5.5,32,17,15,53,3.4,83976,66
1000013-12_angry_men,8.8,36,36,0,100,0,4,4,0,100,4.1,22784,95
atonement,7.3,202,167,35,82,7.6,41,36,5,87,3.8,138297,79
1195800-my_winnipeg,7.8,79,74,5,93,8.2,25,25,0,100,3.8,1541,77
4_months_3_weeks_and_2_days,8.3,131,125,6,95,8.7,33,33,0,100,4,12151,85
no_end_in_sight,8.1,91,86,5,94,8.2,25,24,1,96,4.3,4168,93
brave_one,5.5,179,76,103,42,5.6,34,13,21,38,3.4,78908,65
in_the_valley_of_elah,7,154,112,42,72,7.1,38,27,11,71,3.7,15462,77
i_could_never_be_your_woman,5.5,10,6,4,60,0,3,2,1,66,3.1,13048,45
december_boys,5,67,28,39,41,5.4,16,8,8,50,3.3,14517,55
1183674-hunting_party,6,89,47,42,52,5.8,26,12,14,46,3.4,13820,67
eastern_promises,7.6,190,169,21,88,7.4,35,30,5,85,3.8,66267,82
brooklyn_rules,5.4,39,18,21,46,5.4,14,5,9,35,3.2,11794,51
unreasonable_man,7.4,59,54,5,91,7.5,22,20,2,90,3.9,2169,81
1022531-vengeance_is_mine,7.7,5,5,0,100,0,0,0,0,0,0,0,0
1174399-in_the_shadow_of_the_moon,7.9,108,102,6,94,7.9,35,35,0,100,4.2,2605,90
stephanie_daley,7.3,49,44,5,89,7.8,17,16,1,94,2.9,2917,51
1194842-love_and_other_disasters,3.5,5,1,4,20,0,2,0,2,0,3.4,3576,59
10007916_interview,6,121,70,51,57,5.8,31,15,16,48,3.2,14637,53
resident_evil_extinction,4.3,91,20,71,21,3.7,12,2,10,16,3.4,145880,63
mr_woodcock,4,108,14,94,12,4.6,23,6,17,26,2.8,78350,35
good_luck_chuck,2.8,110,5,105,4,2.7,22,0,22,0,3.3,118715,61
into_the_wild,7.5,181,149,32,82,7.2,37,27,10,72,4.2,82515,90
the_gameplan,4.6,96,26,70,27,4.9,22,9,13,40,3.6,118618,75
lust_caution,6.6,140,100,40,71,6.1,38,22,16,57,3.9,28527,83
feast_of_love,5.3,113,45,68,39,5.8,29,16,13,55,3.1,17049,57
postal,3,39,3,36,7,2.2,10,0,10,0,2.6,11460,34
dark_rising,0,0,0,0,0,0,0,0,0,0,0,0,0
the_heartbreak_kid,4.7,153,47,106,30,4.6,32,9,23,28,2.9,91228,41
dan_in_real_life,6.2,167,107,60,64,6.6,35,22,13,62,3.5,112489,70
darjeeling_limited,6.5,166,113,53,68,6.1,35,20,15,57,3.7,57824,79
we_own_the_night,5.8,144,81,63,56,5.8,32,19,13,59,3.4,84878,63
golden_age,5.1,162,56,106,34,5,37,10,27,27,3.3,74366,62
michael_clayton,7.6,192,173,19,90,7.9,37,35,2,94,3.6,123924,72
sleuth,5.1,118,42,76,35,5.1,30,10,20,33,3.2,9724,53
1175569-lars_and_the_real_girl,7.1,132,107,25,81,7.1,35,28,7,80,3.8,44751,84
30_days_of_night,5.5,150,73,77,48,5.1,28,13,15,46,3.3,146766,57
rendition,5.4,150,69,81,46,5.2,34,12,22,35,3.3,58911,63
things_we_lost_in_the_fire,6.5,121,78,43,64,6.8,29,20,9,68,3.6,18238,73
reservation_road,5.2,108,39,69,36,4.8,31,8,23,25,3.3,6196,54
gone_baby_gone,7.7,164,154,10,93,7.4,36,33,3,91,3.8,95109,84
comebacks,2.7,33,3,30,9,2.6,11,1,10,9,2.8,27630,38
assassination_of_jesse_james_by_the_coward_robert_ford,7.1,162,121,41,74,6.6,36,22,14,61,3.7,57534,73
10th_and_wolf,4,27,5,22,18,3.5,10,1,9,10,3.1,9910,44
beaufort,7,48,42,6,87,7.6,14,12,2,85,3.7,1055,71
1193085-irina_palm,5.9,45,30,15,66,5.7,15,8,7,53,3.7,2412,77
reed_fish,5.1,20,11,9,55,4.3,7,3,4,42,3.2,2282,45
1178221-final_season,4.6,51,14,37,27,5.1,12,5,7,41,3.7,1192,68
persepolis,8.2,145,140,5,96,8.1,37,36,1,97,4.2,29722,92
control,7.4,107,93,14,86,7.3,26,23,3,88,4.1,22741,88
1175178-jane_austen_book_club,6.1,112,73,39,65,6.8,26,22,4,84,3.5,13572,68
last_winter,6.6,49,37,12,75,6.9,16,13,3,81,2.7,1701,33
1174809-silk,3.8,55,4,51,7,4.2,17,2,15,11,2.8,5170,33
golden_age,5.1,162,56,106,34,5,37,10,27,27,3.3,74366,62
i_want_someone_to_eat_cheese_with,6.5,48,35,13,72,6.8,17,14,3,82,2.9,2261,38
black_sheep,6.4,87,61,26,70,6.3,21,15,6,71,3.2,19454,54
1193111-edge_of_heaven,7.7,70,62,8,88,7.7,22,20,2,90,4.1,5659,89
saw_4,3.7,71,12,59,16,2.6,15,0,15,0,3.5,171505,70
my_moms_new_boyfriend,0,2,0,2,0,0,0,0,0,0,0,0,0
for_the_bible_tells_me_so,7.5,47,46,1,97,7.6,16,16,0,100,4.1,1345,89
full_of_it,3,17,1,16,5,3.7,7,1,6,14,3.1,9568,48
my_kid_could_paint_that,7.8,79,74,5,93,7.7,22,21,1,95,3.7,2712,78
elite_squad,5.1,34,18,16,52,0,4,2,2,50,4.1,5760,88
o-ano-em-que-meus-pais-sairam-de-ferias-the-year-my-parents-went-on-vacation,7,50,41,9,82,7.4,12,11,1,91,3.9,1471,80
king_of_california,6.2,67,42,25,62,6.4,26,17,9,65,3.4,5772,64
martian_child,5,104,34,70,32,4.6,29,6,23,20,3.7,48559,73
american_gangster,7,206,163,43,79,6.9,42,32,10,76,4,673602,87
bee_movie,5.7,165,84,81,50,5.9,37,19,18,51,3.3,137161,57
before_the_devil_knows_youre_dead,7.7,158,138,20,87,8,39,36,3,92,3.5,22578,69
diving_bell_and_the_butterfly,8.2,155,144,11,92,8.2,39,37,2,94,4,34371,91
no_country_for_old_men,8.5,223,211,12,94,8.1,44,40,4,90,4,197109,84
be_kind_rewind,6.2,123,80,43,65,5.9,30,16,14,53,3.2,64435,57
1187621-itty_bitty_titty_committee,5,8,3,5,37,0,1,0,1,0,3.3,2011,57
10007792-crazy_love,7,84,65,19,77,7,32,26,6,81,3.6,2624,70
1046129-fugitive,7.6,52,49,3,94,8,9,9,0,100,3.6,28862,82
august_rush,4.8,120,44,76,36,4.4,27,7,20,25,4,105941,84
1005724-desperate_hours,7,5,4,1,80,0,0,0,0,0,0,0,0
du_levande,7.8,36,36,0,100,8,8,8,0,100,3.9,2317,81
man_from_earth,0,3,3,0,100,0,0,0,0,0,0,0,0
hellfighters,3.9,7,1,6,14,0,2,0,2,0,3.6,1128,77
lions_for_lambs,4.8,177,47,130,26,4.6,38,7,31,18,3.1,54996,49
1175076-fred_claus,4.2,135,28,107,20,4.3,32,6,26,18,3,100236,49
beowulf,6.5,189,133,56,70,6.5,36,25,11,69,3.1,101491,52
mr_magoriums_wonder_emporium,4.9,120,44,76,36,4.6,27,7,20,25,3.1,57793,56
love_in_the_time_of_cholera,4.8,107,29,78,27,4.6,29,7,22,24,3.2,20459,48
southland_tales,4.5,92,33,59,35,4.5,23,9,14,39,2.8,13816,43
kansas_city_confidential,5.9,7,6,1,85,0,0,0,0,0,0,0,0
10008703-rails_and_ties,4.6,45,15,30,33,4.3,19,4,15,21,3.2,1200,61
10008700-darfur_now,6.6,57,39,18,68,6.6,24,17,7,70,3.7,1145,74
i_served_the_king_of_england,7.2,81,65,16,80,7.1,27,23,4,85,3.7,1497,80
texas_terror,0,1,0,1,0,0,0,0,0,0,0,0,0
blame_it_on_fidel,7.4,43,40,3,93,7.8,12,11,1,91,4.1,2344,90
mist,6.6,138,101,37,73,5.8,30,17,13,56,3.3,71785,64
enchanted,7.3,157,145,12,92,7.4,34,31,3,91,3.8,188655,80
last_hit_man,0,0,0,0,0,0,0,0,0,0,0,0,0
this_christmas,5.9,80,44,36,55,6.1,23,14,9,60,4.1,54791,82
p2,4.3,68,23,45,33,4,15,4,11,26,2.9,29255,39
om_shanti_om,6.9,7,6,1,85,0,1,1,0,100,4,9245,78
awake,4.3,54,13,41,24,4.4,12,3,9,25,3.2,58950,58
his_dark_materials_the_golden_compass,5.6,186,79,107,42,5.6,35,17,18,48,3.2,145319,55
i_am_legend,6.3,206,142,64,68,6.1,43,25,18,58,3.6,597704,69
1184827-alvin_and_the_chipmunks,4.4,104,28,76,26,4.3,25,6,19,24,3.6,165304,73
futurama_the_movie_benders_big_score,7.6,7,7,0,100,0,0,0,0,0,0,0,0
margot_at_the_wedding,5.6,162,84,78,51,5.9,34,21,13,61,2.8,9682,39
im_not_there_suppositions_on_a_film_concerning_dylan,7,152,116,36,76,7,37,27,10,72,3.5,26869,69
savages,7.4,165,147,18,89,7.8,37,36,1,97,3.4,26746,72
orfanato,7.3,154,132,22,85,7.3,28,25,3,89,4,38413,85
juno,8.1,197,184,13,93,8.4,35,35,0,100,4.1,335812,89
my_blueberry_nights,5.4,120,57,63,47,5,30,9,21,30,3.4,19153,62
starting_out_in_the_evening,7.3,97,84,13,86,7.6,33,27,6,81,3.6,1511,68
10008755-redacted,5.3,103,45,58,43,5.2,30,13,17,43,2.9,3154,46
helvetica,7.1,16,14,2,87,8.1,6,6,0,100,3.9,2857,81
bucket_list,5.1,163,66,97,40,4.6,35,9,26,25,3.8,126324,81
kite_runner,6.4,169,111,58,65,6.7,36,26,10,72,3.7,45797,85
shattered,0,3,1,2,33,0,0,0,0,0,0,0,0
1196345-go_getter,5.6,23,10,13,43,6.2,11,6,5,54,3.5,1556,66
the-flock,0,2,1,1,50,0,0,0,0,0,0,0,0
10008424-love_story,0,1,1,0,100,0,0,0,0,0,0,0,0
1174085-vitus,6.6,59,38,21,64,6.3,19,10,9,52,3.8,10168,77
1175778-longford,0,4,4,0,100,0,1,1,0,100,0,0,0
big_bad_swim,0,3,2,1,66,0,1,1,0,100,3.6,407,73
1183955-1183955-sweeney_todd_the_demon_barber_of_fleet_street,7.6,215,184,31,85,7.5,38,32,6,84,3.9,1391688,81
national-treasure-2-book-of-secrets,4.7,118,39,79,33,4.6,25,8,17,32,3.6,1237906,72
there_will_be_blood,8.4,202,184,18,91,8.2,39,37,2,94,4,110828,84
charlie_wilsons_war,7,192,156,36,81,6.9,40,32,8,80,3.5,85573,73
avp2,3.1,66,8,58,12,4,8,3,5,37,2.7,63530,37
walk_hard,6.6,137,102,35,74,6.1,34,25,9,73,3.1,58871,55
jesus-the-great-debate,0,0,0,0,0,0,0,0,0,0,0,0,0
dedication,5.2,45,18,27,40,4.9,17,5,12,29,3.5,5028,64
the-deep2007,0,0,0,0,0,0,0,0,0,0,0,0,0
battlestar_galactica_razor,0,2,2,0,100,0,0,0,0,0,0,0,0
only-love-knows,0,0,0,0,0,0,0,0,0,0,0,0,0
10009063-perfect_holiday,3.8,56,9,47,16,3.6,20,2,18,10,3,24817,57
27_dresses,5,146,59,87,40,4.9,31,8,23,25,3.6,168630,71
cassandras_dream,5.7,115,53,62,46,5.6,30,12,18,40,3.1,18073,51
d_war,3.6,33,9,24,27,3.3,7,1,6,14,2.3,34779,23
bands_visit,7.9,110,108,2,98,8.1,27,27,0,100,3.9,6276,85
10009132-rec,7.8,23,22,1,95,0,1,0,1,0,3.8,30174,77
10008754-flawless,5.7,90,50,40,55,6,17,12,5,70,3.3,5982,56
cloverfield,6.7,190,145,45,76,6.3,35,25,10,71,3.4,188811,67
1188347-mad_money,4.4,103,23,80,22,4.6,30,8,22,26,3.2,45502,52
cleaner,4.4,12,2,10,16,0,3,1,2,33,3.1,6226,45
10009156-he_was_a_quiet_man,6.2,19,15,4,78,0,1,0,1,0,3.3,5213,61
cheyenne_social_club,0,2,2,0,100,0,0,0,0,0,0,0,0
1188234-iron_horse,7.2,7,6,1,85,0,0,0,0,0,0,0,0
three-bad-men,0,0,0,0,0,0,0,0,0,0,0,0,0
1202495-girl_who_leapt_through_time,6.7,15,13,2,86,0,2,2,0,100,4.2,3403,90
sex_and_breakfast,3.4,11,1,10,9,0,3,0,3,0,2.5,1772,24
one_missed_call,2.5,76,0,76,0,2.4,15,0,15,0,2.7,44868,37
sunday-school,0,0,0,0,0,0,0,0,0,0,0,0,0
10008954-untraceable,4.1,143,21,122,14,4.2,31,6,25,19,3.3,68370,56
john_rambo,4.8,138,50,88,36,4,26,6,20,23,3.4,107524,70
how_she_move,6,77,52,25,67,6.1,22,14,8,63,3.3,16237,56
meet_the_spartans,1.9,46,1,45,2,2.4,9,0,9,0,2.4,69166,31
10008606-eye,4.3,74,16,58,21,4.5,10,2,8,20,3.1,57166,51
strange_wilderness,2.3,41,0,41,0,2.2,7,0,7,0,2.7,25360,35
1190660-over_my_dead_body,3.7,103,16,87,15,3.8,30,3,27,10,3.1,34429,47
im-lauf-der-zeit-kings-of-the-road,0,3,3,0,100,0,0,0,0,0,0,0,0
hellboy_2_the_golden_army,7.2,197,171,26,86,7.2,33,29,4,87,3.6,94282,70
ira_and_abby,6,41,28,13,68,6.5,12,9,3,75,3.5,1069,62
in_bruges,7,154,124,30,80,6.7,34,23,11,67,3.9,53258,84
shoes_of_the_fisherman,6.1,6,3,3,50,0,0,0,0,0,0,0,0
caramel,7.1,73,67,6,91,7.2,25,23,2,92,3.9,5165,80
joe_strummer_the_future_is_unwritten,7.3,59,52,7,88,7.7,21,21,0,100,4,3950,85
pleasure_of_your_company,4.3,11,4,7,36,0,1,0,1,0,2.9,7325,40
teeth,6.6,61,50,11,81,6.4,18,15,3,83,3,14996,46
welcome_home_roscoe_jenkins,4.4,77,18,59,23,4.8,27,9,18,33,3.3,34393,65
10009167-fools_gold,3.6,140,14,126,10,3.2,30,0,30,0,3.2,76286,53
blue_state,0,4,1,3,25,0,0,0,0,0,0,0,0
jumper,4,158,26,132,16,3.7,36,1,35,2,3.2,131920,50
its_a_free_world,6.6,18,15,3,83,6.2,6,4,2,66,3.6,1788,70
1174278-definitely_maybe,6.5,142,101,41,71,6,32,21,11,65,3.5,71521,72
i_live_in_fear,6.4,10,7,3,70,0,2,1,1,50,3.6,357,75
the_air_i_breahe,3.9,23,3,20,13,3.6,7,0,7,0,3.4,12498,64
street-thief,0,0,0,0,0,0,0,0,0,0,0,0,0
vantage_point,5,149,51,98,34,4.9,29,8,21,27,3.4,88206,61
spiderwick_chronicles,6.6,142,113,29,79,6.4,31,22,9,70,3.4,73683,67
step_up_2_the_streets,4.8,56,14,42,25,5.1,18,5,13,27,4,92053,81
witless_protection,2.1,28,1,27,3,0,4,0,4,0,3.1,9071,51
other_boleyn_girl,5.3,136,56,80,41,5.2,34,12,22,35,3.4,73595,65
semi_pro,4.5,154,32,122,20,4.8,31,8,23,25,2.9,58206,41
10008621-run_fat_boy_run,5.5,143,69,74,48,5.5,31,17,14,54,3.5,43462,66
taxi_to_the_dark_side,8.3,85,85,0,100,8.2,23,23,0,100,4,2599,88
grace_is_gone,5.9,71,44,27,61,5.9,21,13,8,61,3.1,10636,59
college_road_trip,3.3,70,9,61,12,3.2,18,1,17,5,3.3,41096,56
10000_bc,3.2,139,12,127,8,3.1,29,3,26,10,3,91145,44
1189844-the_bank_job,6.7,137,108,29,78,7.1,31,28,3,90,3.5,60915,74
doomsday,5,65,31,34,47,4.7,10,3,7,30,3.1,35296,47
horton-hears-a-who2008,7,130,102,28,78,7,33,27,6,81,3.7,97604,75
1175174-funny_games,5.6,138,71,67,51,4.7,34,13,21,38,3.2,16153,54
mongol,7.1,98,85,13,86,7.4,27,25,2,92,3.7,11134,75
wardance,7.1,47,40,7,85,7.4,17,15,2,88,4.3,1246,91
love_guru,3.4,161,24,137,14,3.4,35,4,31,11,2.8,42392,39
diary-of-the-dead2007,6.1,125,76,49,60,6.1,26,17,9,65,2.9,13143,43
mister_foe,6.5,60,43,17,71,6.9,13,10,3,76,3.5,5333,72
penelope2008,5.6,125,65,60,52,5.4,28,14,14,50,3.6,48472,74
city_of_men,6.7,76,57,19,75,7.1,24,21,3,87,3.8,3953,77
romulus_my_father,6.1,11,6,5,54,5.6,5,2,3,40,3.6,1466,67
zeitgeist,0,0,0,0,0,0,0,0,0,0,0,0,0
meduzot,7.2,56,48,8,85,7.7,17,16,1,94,3.8,942,77
then_she_found_me,5.5,115,59,56,51,5.5,28,16,12,57,3.1,4911,46
downhill_racer,7.2,14,11,3,78,0,2,2,0,100,3.3,385,54
miss_pettigrew_lives_for_a_day,6.6,138,107,31,77,6.7,29,21,8,72,3.5,21923,70
snow_angels,6.8,107,71,36,66,7,30,20,10,66,3.5,4241,66
10008849-married_life,5.9,114,63,51,55,6.2,28,15,13,53,3,3205,36
the_dark_knight,8.4,275,257,18,93,8,44,40,4,90,4.5,399618,96
quiet_city,7,16,14,2,87,6.8,6,5,1,83,3.4,995,61
10009253-the_hammer,6.1,32,22,10,68,6.3,13,10,3,76,3.9,1768,82
never_back_down,4.4,83,19,64,22,4.4,20,4,16,20,2.9,405469,37
cj7,5.3,76,37,39,48,5.3,20,10,10,50,3.3,6905,55
drillbit_taylor,4.5,138,36,102,26,4.4,30,7,23,23,3.2,45456,49
same_moon,6.5,91,66,25,72,6.6,26,20,6,76,3.8,11693,80
youth_without_youth,4.7,99,30,69,30,4.7,29,8,21,27,3,5756,45
10009192-21,5.2,161,57,104,35,4.9,31,8,23,25,3.7,112101,73
1192938-smart_people,5.6,141,70,71,49,5.8,34,16,18,47,3,26733,41
leatherheads,5.8,160,83,77,51,5.2,32,11,21,34,3,36074,41
stop_loss,6.3,138,89,49,64,6.3,33,22,11,66,2.5,254181,27
shine_a_light,7.4,120,103,17,85,7.3,34,30,4,88,3.6,11885,74
10009318-the_aerial,5.8,10,6,4,60,0,0,0,0,0,0,0,0
a_le_interieur,7.4,12,10,2,83,0,1,1,0,100,3.8,3333,77
nims_island,5.7,96,48,48,50,5.9,24,13,11,54,3.1,45465,50
the_ruins,5.4,85,40,45,47,4.4,12,3,9,25,2.4,29652,32
forgetting_sarah_marshall,7,175,148,27,84,7,37,33,4,89,3.2,102537,75
sex_and_death_101,4.3,39,10,29,25,3.7,13,3,10,23,3,2241,44
1159618-superhero,3.7,48,7,41,14,3.2,12,0,12,0,2.9,45683,37
street_kings,5.1,149,54,95,36,5,30,8,22,26,3.4,41234,63
10008820-visitor,7.7,111,100,11,90,7.9,25,24,1,96,3.6,29598,82
harold_and_kumar_2,5.6,128,69,59,53,5.8,26,15,11,57,3.5,76122,65
99_francs,0,0,0,0,0,0,0,0,0,0,0,0,0
speed_racer,5.1,202,76,126,37,4.6,41,13,28,31,3.2,70251,61
diminished_capacity,5.3,30,10,20,33,4.9,11,3,8,27,2.6,4729,37
1193377-chapter_27,3.9,47,9,38,19,4.8,16,8,8,50,3,5596,43
forbidden_kingdom,6.1,123,79,44,64,5.7,27,18,9,66,3.5,74799,65
where_in_the_world_is_osama_bin_laden,4.9,102,38,64,37,4.6,29,9,20,31,3.3,2558,55
life_before_her_eyes,4.4,91,22,69,24,4.8,21,7,14,33,3.3,6082,55
1195103-happy_go_lucky,7.7,149,138,11,92,8,33,32,1,96,3.4,13094,65
religulous,6.4,149,104,45,69,6,33,21,12,63,3.8,16867,79
outpost_2007,0,2,1,1,50,0,0,0,0,0,0,0,0
son_of_rambow,6.8,114,84,30,73,6.8,27,20,7,74,3.7,17821,79
super-high-me,5.3,7,4,3,57,0,1,0,1,0,3.4,2525,56
invisible_ray,6.2,5,4,1,80,0,0,0,0,0,0,0,0
1011558-killer_elite,6,8,5,3,62,0,2,0,2,0,3,599,35
10009724-deception,3.8,94,12,82,12,3.5,27,2,25,7,3,23525,37
baby_mama,6.2,157,99,58,63,6,37,23,14,62,3.4,80435,59
10006828-klimt,5,24,7,17,29,5.6,8,4,4,50,2.7,1898,32
expelled_no_intelligence_allowed,2.9,41,4,37,9,2.5,17,0,17,0,3.5,8732,70
prom_night,2.8,60,5,55,8,2.4,9,1,8,11,3,51435,46
die-weisse-massai-the-white-massai,6.3,7,5,2,71,0,2,2,0,100,3.7,628,72
made_of_honor,4,111,15,96,13,4.4,27,5,22,18,3.4,79802,61
redbelt,6.3,137,93,44,67,6.5,31,22,9,70,3.4,9293,64
1192616-mister_lonely,5.2,68,30,38,44,5.1,19,8,11,42,3.4,2212,59
anamorph,4.5,26,6,20,23,4.9,8,3,5,37,2.7,1453,26
taken,5.8,160,92,68,57,5.2,33,14,19,42,4,307912,83
flight_of_the_red_balloon,6.9,82,65,17,79,7.3,22,19,3,86,3.4,1609,59
the-fall-2008,6.2,101,60,41,59,5.8,21,9,12,42,3.8,23397,85
stargate_the_ark_of_truth,0,4,3,1,75,0,0,0,0,0,0,0,0
10008830-bill,3.8,19,4,15,21,2.7,7,0,7,0,3.1,4060,46
american_crime,4.6,11,3,8,27,0,2,0,2,0,3.8,6057,79
10008760-what_happens_in_vegas,4.5,128,36,92,28,4.5,31,9,22,29,3.7,109183,72
bella,5.4,62,26,36,41,5.2,24,8,16,33,4,8808,81
1185184-1185184-unknown_soldier,6.1,10,6,4,60,0,3,1,2,33,4.2,59,88
chronicles_of_narnia_prince_caspian,6.3,179,120,59,67,6.2,37,23,14,62,3.8,154104,78
1196293-reprise,7.4,77,67,10,87,7.7,23,20,3,86,3.9,2013,82
youngheart,7.5,97,85,12,87,7.7,23,21,2,91,4.2,3340,91
war_inc,4.6,79,24,55,30,3.9,22,4,18,18,2.9,17107,40
1130343-girl_next_door,5.6,156,87,69,55,5,32,17,15,53,3.3,39311,71
10008698-king_corn,7.7,20,19,1,95,7.8,9,9,0,100,3.8,1280,78
indiana_jones_and_the_kingdom_of_the_crystal_skull,6.9,246,190,56,77,6.1,41,25,16,60,3.4,252104,59
1196178-patti_smith_dream_of_life,6.4,37,24,13,64,6.8,14,11,3,78,3.7,513,76
lake_of_fire,7.7,51,48,3,94,7.7,16,16,0,100,4.1,1243,90
10008924-oxford_murders,3.8,10,1,9,10,0,2,0,2,0,2.9,7692,37
4bia-phobia,0,0,0,0,0,0,0,0,0,0,0,0,0
10009244-the_grand,5.2,42,16,26,38,5.1,15,6,9,40,3.1,1445,45
sex_and_the_city,5.5,173,85,88,49,5.5,41,21,20,51,3.9,147793,81
the_strangers,5,146,65,81,44,4.8,26,13,13,50,3.1,55773,48
savage_grace,4.9,89,34,55,38,4.9,25,10,15,40,2.9,3544,40
bigger_stronger_faster_asterisk,7.7,73,70,3,95,7.8,19,19,0,100,3,9818,73
boys_love,0,1,0,1,0,0,0,0,0,0,0,0,0
kung_fu_panda,7.2,163,144,19,88,6.8,34,26,8,76,3.9,162469,83
what_would_jesus_buy,6.2,54,32,22,59,6,14,9,5,64,3.4,1220,57
1198569-recount,6.4,17,13,4,76,6.6,10,8,2,80,3.8,2167,81
kunsten-at-graede-i-kor-the-art-of-crying,6,6,3,3,50,0,2,2,0,100,3.9,561,84
where_the_sidewalk_ends,7.6,9,9,0,100,0,3,3,0,100,3.7,424,80
100_rifles,0,2,0,2,0,0,1,0,1,0,3.3,243,47
10009624-promotion,5.8,76,41,35,53,5.3,21,10,11,47,2.8,7926,29
when_did_you_last_see_your_father,6.6,93,68,25,73,6.8,23,18,5,78,3.1,5170,62
mio_fratello_e_figlio_unico,7,59,51,8,86,7.1,18,16,2,88,3.8,1781,79
stuck,6.3,86,62,24,72,6.3,22,16,6,72,3.2,1652,55
chaos_theory,5,56,17,39,30,4.7,20,3,17,15,3.4,4938,61
boy-a,7.5,57,51,6,89,7.5,23,20,3,86,3.5,5895,84
10007985-happening,4,168,30,138,17,3.8,36,4,32,11,2.7,85481,29
the_incredible_hulk,6.1,210,138,72,65,5.7,38,21,17,55,3.6,124298,75
baghead,6.6,90,69,21,76,6.9,27,22,5,81,3,1311,47
wall_e,8.4,226,217,9,96,8.5,40,39,1,97,4.2,192598,89
1174279-wanted,6.5,196,139,57,70,6.8,39,29,10,74,3.7,934918,72
hancock,5.4,211,85,126,40,5,39,13,26,33,3.7,184958,67
get_smart,5.5,206,105,101,50,5.5,38,20,18,52,3.6,117099,73
brick_lane,6.2,94,61,33,64,6.4,22,13,9,59,3,3292,58
surfwise,7.4,42,41,1,97,7,11,10,1,90,2.9,6425,61
deep-crates-2,0,0,0,0,0,0,0,0,0,0,0,0,0
st_trinians,4.3,40,13,27,32,4,10,2,8,20,3.4,19189,58
roman_de_gare,7.1,73,64,9,87,7.2,24,20,4,83,3.7,1112,76
futurama_the_movie_beast_with_a_billion_backs,0,4,4,0,100,0,0,0,0,0,0,0,0
1168888-archangel,0,1,1,0,100,0,0,0,0,0,0,0,0
sayat-nova-color-of-pomegranates,7.4,6,5,1,83,0,0,0,0,0,0,0,0
finding_amanda,5.2,41,17,24,41,5.5,14,5,9,35,2.8,997,30
kit_kittredge_an_american_girl,6.7,96,75,21,78,7,24,22,2,91,3.2,19095,64
gonzo-the-life-and-work-of-dr-hunter-s-thompson,7.1,91,79,12,86,7.5,22,20,2,90,3.3,7310,79
wackness,6.3,124,85,39,68,6.5,25,19,6,76,3.6,8603,72
up_the_yangtze,7.7,47,45,2,95,8.3,15,15,0,100,3.9,954,83
along_came_jones,0,4,1,3,25,0,0,0,0,0,0,0,0
sleepwalking,4.2,57,10,47,17,4.3,22,4,18,18,3,8038,45
1194818-encounters_at_the_end_of_the_world,7.6,105,98,7,93,8,21,21,0,100,3.4,4183,80
mauvais_sang,0,3,2,1,66,0,0,0,0,0,0,0,0
zombie_strippers,4.6,61,24,37,39,4.3,11,3,8,27,2.6,3970,33
battle_for_haditha,6,29,19,10,65,6.6,11,9,2,81,3.7,1153,73
10008234-alexandra,7.5,51,47,4,92,8.3,11,11,0,100,3.6,547,69
transylvania,5.6,18,13,5,72,0,2,1,1,50,3.8,788,78
mamma_mia,5.5,173,92,81,53,5.2,38,16,22,42,3.8,126612,76
1078955-game,7.2,43,30,13,69,7.2,11,7,4,63,3.5,23139,82
pornographers,8,8,8,0,100,0,0,0,0,0,0,0,0
kabluey,6.9,36,30,6,83,6.9,11,9,2,81,3.4,1396,65
10009890-stone_angel,5.4,21,9,12,42,6.1,8,4,4,50,3.4,966,59
1173563-rogue,7.7,11,11,0,100,0,1,1,0,100,3.2,3997,52
no_regrets_for_our_youth,0,2,2,0,100,0,0,0,0,0,0,0,0
its_the_great_pumpkin_charlie_brown,7.3,15,14,1,93,0,0,0,0,0,0,0,0
1207748-katyn,7.4,59,54,5,91,8.1,15,15,0,100,3.7,3505,75
10008588-journey_3d,6,148,91,57,61,6.6,31,24,7,77,3.2,38002,55
meet_dave,4.1,98,19,79,19,4.6,24,7,17,29,3,22234,42
machine_girl,6.4,8,5,3,62,0,3,2,1,66,3.5,2727,63
august_rush,4.8,120,44,76,36,4.4,27,7,20,25,4,105941,84
death_defying_acts,5,36,16,20,44,5.3,6,2,4,33,2.9,2068,31
water_lilies,6.5,42,32,10,76,6.5,11,9,2,81,3.5,1175,65
just-another-love-story-kaerlighed-pa-film,6.2,42,31,11,73,6.5,10,8,2,80,3.8,956,82
heartbeat_detector,6.5,25,19,6,76,7.2,9,8,1,88,3,290,46
moving_mcallister,2.8,10,1,9,10,0,1,1,0,100,2.8,1079,32
transsiberian,7.2,75,68,7,90,7.3,17,16,1,94,3.4,6508,62
1195801-space_chimps,4.7,89,32,57,35,4.5,17,8,9,47,2.8,24188,37
une_vieille_maitresse,6.7,90,68,22,75,7.6,21,19,2,90,3.4,1490,60
stargate_continuum,0,1,1,0,100,0,0,0,0,0,0,0,0
conspiracy,0,2,0,2,0,0,1,0,1,0,2.5,968,22
steal_a_pencil_for_me,7.7,22,21,1,95,8.1,8,8,0,100,3.8,296,80
shotgun_stories,7.3,40,37,3,92,7.1,10,9,1,90,3.8,1261,79
1192728-blast_of_silence,7,11,9,2,81,0,2,2,0,100,3.9,432,84
1193743-step_brothers,5.5,176,96,80,54,5.1,34,16,18,47,3.6,77495,68
brideshead_revisited,6.1,126,79,47,62,6.5,30,21,9,70,3.2,6004,52
x_files_2,4.8,155,48,107,30,4.5,30,7,23,23,2.8,52241,34
american_teen,6.5,145,103,42,71,7,33,25,8,75,3,11887,59
man_on_wire,8.4,145,145,0,100,8.4,32,32,0,100,4,10237,88
10008496-pathology,4.7,19,9,10,47,0,4,2,2,50,3,12698,44
edge_of_love,5.1,55,20,35,36,4.5,13,4,9,30,3,18391,45
mummy_tomb_of_the_dragon_emperor,3.7,161,21,140,13,3.7,32,3,29,9,3,79989,40
swing_vote,5.1,143,53,90,37,5.3,29,15,14,51,3,24529,45
10008617-midnight_meat_train,6.2,27,19,8,70,0,2,1,1,50,3.1,24490,49
frozen_river,7.3,125,109,16,87,7.9,26,24,2,92,3.2,9338,71
sixty-six,5.9,48,31,17,64,5.8,14,9,5,64,3.5,1205,65
bottle_shock,5.6,116,56,60,48,6.1,29,16,13,55,3.3,4827,60
vicky_cristina_barcelona,6.9,188,154,34,81,7.2,35,29,6,82,3.6,45494,73
eve_and_the_fire_horse,7.1,12,10,2,83,0,4,3,1,75,3.8,936,79
10008436-the_end_of_summer,0,4,4,0,100,0,0,0,0,0,0,0,0
the_walker,5.3,62,32,30,51,5.8,18,10,8,55,2.8,2117,31
pineapple_2008,0,0,0,0,0,0,0,0,0,0,0,0,0
1217360-silent_light,0,4,4,0,100,0,0,0,0,0,0,0,0
expired,5.6,22,13,9,59,5.7,7,4,3,57,3,388,45
sisterhood_of_the_traveling_pants_2,6,92,59,33,64,6.5,29,22,7,75,3.4,36715,68
1192781-hell_ride,3.5,59,6,53,10,3.5,19,2,17,10,2.7,3570,33
1194209-elegy,6.7,112,83,29,74,6.9,28,21,7,75,3.2,10624,60
high_school_musical,5.4,8,5,3,62,0,0,0,0,0,0,0,0
tropic_thunder,7.1,221,183,38,82,6.9,40,33,7,82,3.5,90369,69
clone_wars,4.2,152,29,123,19,3.7,26,4,22,15,3.1,40439,46
henry_poole_is_here,5,87,32,55,36,5.2,22,8,14,36,3.3,4016,56
mutant_chronicles,3.6,31,5,26,16,0,2,0,2,0,2.5,18903,27
waltz_with_bashir,8.4,134,129,5,96,8.4,31,30,1,96,4,15959,89
lat_den_ratte_komma_in,8.2,158,154,4,97,7.9,30,29,1,96,4.2,25695,89
1075422-hamlet,8.2,54,51,3,94,7.2,14,11,3,78,3.8,5816,86
death_race,4.8,145,60,85,41,5.2,23,10,13,43,3.5,50505,69
house_bunny,5.1,120,47,73,39,5.2,23,8,15,34,3.2,46575,55
longshots,5.2,68,28,40,41,5,19,7,12,36,3.5,8258,66
10009055-rocker,5.2,119,48,71,40,5.2,30,11,19,36,3.2,13841,52
i_o_u_s_a,7.2,59,52,7,88,7.9,14,14,0,100,3.9,762,83
1197016-mirrors,3.9,81,12,69,14,3.5,10,0,10,0,3.2,31437,50
fly_me_to_the_moon,3.9,78,14,64,17,4.2,20,4,16,20,2.6,1597,27
variety_lights,8.1,10,10,0,100,0,1,1,0,100,3.6,271,68
sukiyaki_western_django,5.7,49,28,21,57,5.2,10,4,6,40,3.4,5732,59
noise,0,2,2,0,100,0,0,0,0,0,0,0,0
burn_after_reading,6.8,217,169,48,77,6.2,42,26,16,61,3.4,71248,64
disaster_movie,1.8,61,1,60,1,2.2,9,0,9,0,2.3,26026,28
babylon_ad,3.2,97,7,90,7,2.8,13,0,13,0,2.8,29288,32
traitor,6.1,160,98,62,61,5.7,33,18,15,54,3.4,19383,67
1191620-college,2.5,40,2,38,5,2.8,12,1,11,8,2.8,10667,35
trouble_the_water,8.1,70,68,2,97,8.1,21,21,0,100,4,896,86
10009516-women,3.9,142,18,124,12,3.8,34,4,30,11,3,20081,41
onion_movie,0,2,0,2,0,0,0,0,0,0,0,0,0
the_spirit,3.6,108,16,92,14,3.4,27,2,25,7,2.6,56971,30
oh_what_a_lovely_war,0,1,1,0,100,0,0,0,0,0,0,0,0
bangkok_dangerous,3.4,92,8,84,8,3.3,15,1,14,6,2.8,23793,33
boys_in_company_c,0,0,0,0,0,0,0,0,0,0,0,0,0
un_secret,7,43,34,9,79,7.4,15,12,3,80,3.5,1538,62
august_evening,7.1,23,21,2,91,6.7,9,7,2,77,3.8,206,68
10005901-sunflower,6.1,13,9,4,69,5.3,6,3,3,50,3.8,344,77
son_of_lassie,0,3,2,1,66,0,0,0,0,0,0,0,0
darkbluealmostblack,6.4,18,13,5,72,0,4,2,2,50,3.9,1509,83
the-foot-fist-way,5.5,81,43,38,53,6.5,24,17,7,70,3.1,2433,46
righteous_kill,4.1,138,27,111,19,3.8,28,3,25,10,3.1,29471,45
1196215-lakeview_terrace,5.5,153,70,83,45,5.7,31,17,14,54,3.1,23932,44
1184137-ladron_que_roba_a_ladron,5.6,27,17,10,62,6,10,7,3,70,3.7,1644,73
shadows_in_paradise,0,1,1,0,100,0,0,0,0,0,0,0,0
1190970-ghost_town,6.9,173,147,26,84,6.9,35,30,5,85,3.3,23409,61
maradona-by-kusturica,0,0,0,0,0,0,0,0,0,0,0,0,0
importexport,6.9,29,24,5,82,6.8,5,4,1,80,3.8,567,76
crow_wicked_prayer,2,5,0,5,0,0,0,0,0,0,0,0,0
1190240-en_la_cama,5.4,5,2,3,40,0,1,1,0,100,3.6,471,66
private-parts,0,0,0,0,0,0,0,0,0,0,0,0,0
freebie_and_the_bean,0,4,2,2,50,0,0,0,0,0,0,0,0
sawdust_and_tinsel,8,9,9,0,100,0,1,1,0,100,4,575,83
humboldt_county,5.7,19,11,8,57,5.7,5,3,2,60,3.4,626,60
boot-camp,0,0,0,0,0,0,0,0,0,0,0,0,0
beach,4.4,116,22,94,18,3.9,31,4,27,12,2.9,21479,59
sanma-no-aji-an-autumn-afternoon-the-widower,7.8,11,10,1,90,0,3,2,1,66,4.2,448,89
project-moonbase,0,1,0,1,0,0,0,0,0,0,0,0,0
10008785-appaloosa,6.6,156,119,37,76,6.6,34,25,9,73,3.2,19629,55
miracle_at_st_anna,5.2,113,38,75,33,4.8,32,8,24,25,3.3,8435,56
katok-i-skripka-the-steamroller-and-the-violinthe-skating-rink-and-the-violin,7.6,6,5,1,83,0,1,1,0,100,3.9,347,80
kasky-tears-of-april,0,0,0,0,0,0,0,0,0,0,0,0,0
1000055-1984,6.4,14,11,3,78,0,1,1,0,100,3.5,17133,70
eagle_eye,4.6,172,47,125,27,4.7,31,8,23,25,3.7,73300,72
how_to_lose_friends_and_alienate_people,5,108,40,68,37,4.3,26,6,20,23,3.1,16565,48
nights_in_rodanthe,4.8,128,40,88,31,4.4,27,6,21,22,3.3,26775,56
1012672-look_back_in_anger,7.7,8,7,1,87,0,0,0,0,0,0,0,0
nick_and_norahs_infinite_playlist,6.5,169,123,46,72,6.9,33,27,6,81,3.5,38982,67
marjoe,7.9,5,5,0,100,0,2,2,0,100,3.9,94,84
martyrs,5.7,24,12,12,50,0,1,0,1,0,3.6,4312,71
1058966-red,8.5,40,40,0,100,8.2,10,10,0,100,4.2,9569,94
jalsaghar,9,9,9,0,100,0,4,4,0,100,4.4,358,95
gomorrah,7.6,136,124,12,91,8.1,34,33,1,97,3.5,21931,67
accidental_husband,2.8,16,1,15,6,0,0,0,0,0,0,0,0
10009493-duchess,6.3,161,98,63,60,6.6,35,24,11,68,3.5,22537,69
alone_in_the_dark,1.7,116,1,115,0,1.7,26,0,26,0,2.1,8641,21
1135165-dead_leaves,0,0,0,0,0,0,0,0,0,0,0,0,0
flcl-fooly-cooly,0,0,0,0,0,0,0,0,0,0,0,0,0
rachel_getting_married,7.5,187,160,27,85,7.8,41,37,4,90,3.3,19208,61
10009225-body_of_lies,5.8,194,102,92,52,5.6,40,21,19,52,3.5,38376,66
city_of_ember,5.7,121,63,58,52,5.9,27,16,11,59,3.2,14662,47
magicians,4.2,7,2,5,28,0,1,0,1,0,0,0,0
autism_the_musical,0,2,2,0,100,0,1,1,0,100,4.1,335,89
max_payne,3.7,128,21,107,16,3.4,26,2,24,7,2.9,48802,36
1190296-zack_and_miri_make_a_porno,6.1,183,119,64,65,5.6,36,17,19,47,3.6,63027,70
w_2008,6,205,123,82,60,5.4,40,17,23,42,3,24739,43
10008611-my_best_friends_girl,3.5,56,8,48,14,3.7,12,2,10,16,3.2,22662,52
synecdoche_new_york,6.6,172,116,56,67,6.4,35,22,13,62,3.6,14060,69
drowning_pool,5.4,12,7,5,58,0,4,1,3,25,3.3,312,48
secret_life_of_bees,5.9,131,75,56,57,6.2,27,17,10,62,3.7,35593,79
flash_of_genius,6,102,60,42,58,5.2,28,10,18,35,3.4,3988,56
an_american_carol,2.9,44,5,39,11,3.1,11,0,11,0,2.9,6246,48
1206901-wave,5.8,13,9,4,69,0,1,1,0,100,3.9,4370,83
deux_mondes,0,0,0,0,0,0,0,0,0,0,0,0,0
tokyo_ga_2003,0,0,0,0,0,0,0,0,0,0,0,0,0
kuroi-kawa,0,0,0,0,0,0,0,0,0,0,0,0,0
angus_thongs_and_perfect_snogging,6,24,17,7,70,0,2,1,1,50,3.9,6295,76
bad-eggs,0,0,0,0,0,0,0,0,0,0,0,0,0
niko-and-the-way-to-the-stars,0,0,0,0,0,0,0,0,0,0,0,0,0
1196221-quarantine,5.7,77,45,32,58,4.8,9,4,5,44,3,32796,47
black_moon_rising,3.9,9,3,6,33,0,2,1,1,50,2.8,1020,32
boy_a,3.2,7,0,7,0,0,0,0,0,0,0,0,0
pride_and_glory,5.1,150,51,99,34,5.3,30,9,21,30,3.3,23470,54
fifty_pills,0,1,0,1,0,0,0,0,0,0,0,0,0
1185801-the_express,6.2,114,70,44,61,6.4,28,19,9,67,3.1,11362,74
lone-wolf-and-cub-baby-cart-to-hades,0,1,1,0,100,0,0,0,0,0,0,0,0
lone-wolf-and-cub-baby-cart-in-peril,0,1,1,0,100,0,0,0,0,0,0,0,0
babylon_5_the_legend_of_the_rangers,0,0,0,0,0,0,0,0,0,0,0,0,0
babylon_5_the_lost_tales,0,0,0,0,0,0,0,0,0,0,0,0,0
rocknrolla,6,140,84,56,60,6.1,35,22,13,62,3.6,25930,72
zen_noir,3.4,14,4,10,28,3.9,5,2,3,40,3.9,274,70
1194524-high_school_musical_3_senior_year,5.9,127,83,44,65,6,27,18,9,66,3.6,80210,76
1023635-wicked_lady,0,0,0,0,0,0,0,0,0,0,0,0,0
futurama_benders_game,0,1,0,1,0,0,0,0,0,0,0,0,0
1046771-into_the_west,6.4,10,7,3,70,0,2,1,1,50,3.6,744,73
madagascar_escape_2_africa,5.9,145,93,52,64,6.3,30,18,12,60,3.7,89627,73
1188215-blindness,5.2,150,63,87,42,5,30,8,22,26,3.1,17761,49
1191742_changeling,6.3,190,117,73,61,5.6,39,17,22,43,3.8,63438,84
za-ginipiggu-2-chiniku-no-hana-guinea-pig-2-flowers-of-flesh-and-blood,0,0,0,0,0,0,0,0,0,0,0,0,0
slumdog_millionaire,8.2,220,206,14,93,8.2,38,36,2,94,4,328969,90
quantum_of_solace,6.1,241,154,87,63,5.6,41,15,26,36,3.5,125850,62
filth_and_wisdom,3.9,58,15,43,25,4.2,23,7,16,30,3,1070,42
1020815-tale_of_two_cities,0,0,0,0,0,0,0,0,0,0,0,0,0
role_models,6.5,152,117,35,76,6.4,34,23,11,67,3.7,63260,75
tokyo_gore_police,6.8,9,9,0,100,0,3,3,0,100,3.4,1468,61
1216162-sauna,0,0,0,0,0,0,0,0,0,0,0,0,0
chaotic_ana,0,2,1,1,50,0,1,1,0,100,3.5,1071,65
jcvd,7,98,83,15,84,7.1,25,21,4,84,3.5,8534,71
1144859-happily_ever_after,6,40,23,17,57,6.3,19,12,7,63,3.6,1061,70
1004186-cinderella,7.3,26,24,2,92,8,5,5,0,100,3.5,63946,76
crows_zero,0,0,0,0,0,0,0,0,0,0,0,0,0
lord_of_war,6.2,141,86,55,60,5.6,33,14,19,42,3.6,51125,84
christmas_story-2009,0,0,0,0,0,0,0,0,0,0,0,0,0
todas_las_azafatas_van_al_cielo,0,0,0,0,0,0,0,0,0,0,0,0,0
camp_rock,5.2,5,1,4,20,0,0,0,0,0,0,0,0
farscape_the_peacekeeper_wars,0,0,0,0,0,0,0,0,0,0,0,0,0
saw_v,2.9,69,9,60,13,2.7,13,1,12,7,3.5,64670,63
10009929-a_christmas_tale,7.5,111,97,14,87,7.9,26,24,2,92,3.4,12013,64
critters_4,0,2,0,2,0,0,0,0,0,0,0,0,0
sex_drive,5.3,107,49,58,45,5.8,25,13,12,52,3.4,18987,61
10009635-soul_men,5,97,44,53,45,5.6,29,17,12,58,3.3,12766,61
10008587-beverly_hills_chihuahua,5,93,38,55,40,5.5,19,9,10,47,3.2,35658,56
christmas_on_mars,5.5,6,3,3,50,0,4,2,2,50,3.3,530,56
goyokiba-hanzo-the-razor-sword-of-justice,0,2,2,0,100,0,0,0,0,0,0,0,0
where_a_good_man_goes,0,1,1,0,100,0,0,0,0,0,0,0,0
face_of_another,7.4,6,6,0,100,0,1,1,0,100,4.1,598,90
three_monkeys,6.7,56,43,13,76,7.7,13,12,1,92,3.6,1239,72
1054231-bellissima,0,2,2,0,100,0,1,1,0,100,4,268,88
tattooed_life,0,0,0,0,0,0,0,0,0,0,0,0,0
bullfighter_and_the_lady,0,1,0,1,0,0,0,0,0,0,0,0,0
wagon_master,0,4,4,0,100,0,0,0,0,0,0,0,0
ring_of_darkness,0,0,0,0,0,0,0,0,0,0,0,0,0
the_class,8.1,143,139,4,97,8.3,33,33,0,100,3.8,6106,80
australia,5.9,199,109,90,54,5.3,38,18,20,47,3.5,75143,69
bolt,7.2,174,154,20,88,6.6,31,24,7,77,3.6,68805,76
milk,8,217,203,14,93,8.3,38,36,2,94,3.9,55245,88
the-devildoll-the-witch-of-timbuctoo,0,0,0,0,0,0,0,0,0,0,0,0,0
twilight,5.5,196,98,98,50,5.9,36,20,16,55,4.1,256646,82
transporter_3,4.8,105,39,66,37,4.7,23,7,16,30,3.4,58914,58
four_christmases,4.3,139,35,104,25,4,27,5,22,18,3.3,79552,52
boy_in_the_striped_pajamas,6.2,132,84,48,63,6.3,28,18,10,64,3.9,31826,85
10010214-fireproof,4.4,20,8,12,40,5.2,6,3,3,50,4.2,14600,87
10009636-igor,4.8,87,31,56,35,4.2,18,3,15,16,3,18397,43
cadillac_records,6.1,118,79,39,66,6.5,33,23,10,69,3.3,13310,64
punisher_war_zone,4.2,96,25,71,26,3.7,21,1,20,4,3,29393,47
bellboy,6.9,9,6,3,66,0,0,0,0,0,0,0,0
shrek_the_halls,0,2,1,1,50,0,0,0,0,0,0,0,0
1037728-lovers,7.3,8,8,0,100,0,0,0,0,0,0,0,0
the-perverts-guide-to-cinema,7.1,20,18,2,90,7.6,9,9,0,100,4,801,84
britannia_hospital,6.8,5,3,2,60,0,0,0,0,0,0,0,0
wallace_and_gromit_a_matter_of_loaf_and_death_pands,0,1,1,0,100,0,0,0,0,0,0,0,0
1009076-gypsy,6.4,11,8,3,72,0,0,0,0,0,0,0,0
ninja_3_the_domination,0,1,0,1,0,0,0,0,0,0,0,0,0
a_man_named_pearl,6.8,29,22,7,75,7,9,8,1,88,4,248,86
1005371-day_the_earth_stood_still,8,50,47,3,94,7,5,4,1,80,3.8,8999,86
1221112-che,6.3,128,84,44,65,5.6,24,14,10,58,3.7,10315,76
che_part_two,6.5,40,31,9,77,0,3,2,1,66,3.5,6290,65
starship_troopers_3,5.4,5,3,2,60,0,0,0,0,0,0,0,0
1039796-boomerang,4.8,27,10,17,37,5.4,8,4,4,50,2.8,4751,55
doubt,6.9,204,159,45,77,6.4,40,28,12,70,3.7,86761,75
forgotten,5,168,51,117,30,4.7,34,10,24,29,2.9,13766,47
gran_torino,7.1,211,169,42,80,6.7,39,28,11,71,4.2,193304,90
frostnixon,7.9,216,198,18,91,7.7,41,37,4,90,3.8,38396,86
reader,6.3,183,112,71,61,6,35,19,16,54,3.7,89822,78
ive_loved_you_so_long,7.4,119,106,13,89,7.7,32,31,1,96,3.9,6732,85
seven_pounds,4.6,180,48,132,26,5,36,13,23,36,3.6,143024,77
pin,0,0,0,0,0,0,0,0,0,0,0,0,0
the_wrestler,8.3,207,202,5,97,8.2,37,36,1,97,3.9,57550,86
chinese_ghost_story_ii,0,1,1,0,100,0,0,0,0,0,0,0,0
the-battle-of-britain1943,0,0,0,0,0,0,0,0,0,0,0,0,0
petites_coupures,0,4,2,2,50,0,0,0,0,0,0,0,0
1097260-arabian_nights,0,3,2,1,66,0,0,0,0,0,0,0,0
more_the_merrier,8.2,12,12,0,100,0,2,2,0,100,3.9,428,85
tuya-de-hun-shi-tuyas-marriage,7.1,31,28,3,90,6.9,11,9,2,81,3.8,595,80
curious_case_of_benjamin_button,7.1,228,165,63,72,6.9,37,28,9,75,3.7,216019,81
yes_man,5.2,144,62,82,43,4.9,31,12,19,38,3.7,141478,72
hexed,2,8,1,7,12,0,2,0,2,0,0,0,0
valkyrie,6,185,113,72,61,6,37,22,15,59,3.5,113378,66
10008685-birds_of_america,0,4,0,4,0,0,2,0,2,0,3.1,1163,47
pete_seeger_the_power_of_song,8.2,20,19,1,95,8,12,11,1,91,4.3,233,93
5_centimeters_per_second,0,2,2,0,100,0,1,1,0,100,4.3,1726,91
war_of_the_worlds,7,244,178,66,72,6.7,42,28,14,66,2.9,162092,45
war_of_the_worlds_2_the_next_wave,0,0,0,0,0,0,0,0,0,0,0,0,0
impulse,0,2,0,2,0,0,0,0,0,0,0,0,0
zona-zamfirova,0,0,0,0,0,0,0,0,0,0,0,0,0
10009212-ben_x,6.3,36,24,12,66,6.1,7,4,3,57,3.9,2886,82
bedtime_stories,4.4,104,26,78,25,4.7,26,6,20,23,3.5,108877,63
manhattan_melodrama,7,12,10,2,83,0,4,2,2,50,3.7,344,71
choke,5.6,135,73,62,54,4.9,26,8,18,30,3.3,13893,55
revolutionary_road,6.7,194,133,61,68,6.9,36,25,11,69,3.5,46044,70
blackadder-back-forth,0,0,0,0,0,0,0,0,0,0,0,0,0
